abilitet	ability
abolera	abolish
abort	miscarriage
abort	abortion
absens	absence
absent	absent
absolutist	teetotaller
absolutt	absolutely
abstrakt	abstract
absurd	absurd
adapta	adapt
adapter	adaptor
adekvat	adequate
adera	add
aderad	added
adisjon	addition
adisjonal	additional
adjektiv	adjective
administrasjon	management
administrasjon	administration
administrativ	administrative
administrera	administer
admira	admire
admiral	admiral
admirasjon	admiration
admisjon	admission
admisjon	admittance
admita	admit
adoptera	adopt
adress/a	address
adressat	addressee
adverb	adverb
advis	advice
advisa	advise
advokat	barrister
advokat	attorney
advokat/a	advocate
advokatt	lawyer
af	off
afeksjon, tilgivenhet	affection
afeksjonatt, tilgiven	affectionate
afekta, beröra	affect
afektad/pretensjös	affected
aferar	Affairs
afholda sej fron	abstain from
afirmativ	affirmative
afliksjon	affliction
aften, kvel	evening
agent	agent
agreja	agree
agrejment	concurrence
agresiv	aggressive
agurk	cucumber
aids	AIDS
akademi	academy
akademisk	academic
akomodasjon	accommodation
akomodera	accommodate
akompagnera	accompany
akordans, enlighet	accordance
aksel	axle
akselera	accelerate
aksent	accent
akseptera	accept
aksepterad	accepted
aksesible, tilgonglig	accessible
aksesoriar	accessories
aksidentell	accidental
aksjon	action
aksjonar	actions
akting	Acting
aktitud	attitude
aktiv	active
aktivitet	activity
aktivitetar	activities
aktor	actor
aktorinne	actress
akuratt	accurate
akutt	acute
akvarell	watercolor
ala/helt	all
alarm/era	alarm
albue	elbow
album	album
alder	age
alderdom	old age
aldrig	never
alene	alone
alergi	allergy
alfabet	alphabet
algebra	algebra
alians	alliance
aliera	ally (v)
alieradar	allies
alimoni	alimony
alkohol	alcohol
alkoholholdig	alcoholic
allej	alley
allergisk	allergic
alm	elm
almanakk	almanac
almen, publik/publikum	public (a/n)
almen/vanlig	common
Almenia	Almenia
almensk/almensker	Almenian
alsidig	all-round
alternativ	alternative
altfor/osso	too
altid	ever
altid	always
alting, alt	Everything
alto	alto
altso	consequently
alvor	earnest
ambasadd	embassy
ambasadör	ambassador
ambisjiös	ambitious
ambrasa	embrace
ambulans	ambulance
amerika	America
amerikanar	Americans
amerikansk/amerikan	American
ametist	amethyst
amnesti	amnesty
amusa	amuse
amusant	amusing
amuselse	amusement
analfabet	illiterate
analisa	analysis
analise	analysis
analisera	analyse
analitiker	analyst
anan/andra	other (a/n)
ananar	others
ananas	pineapple
anarki	anarchy
anarkisme	anarchism
anarkist	anarchist
anatomi	anatomy
and	duck
ande, spiritus, humör,	spirit
andelig, spirituell	spiritual
andra/sekund	second
aneks/anektera	annex
anemi	anaemia
anemia, blodbrist	anemia
anemik	anemic
anestesia	anesthesia
anestetikk	anesthetic
anetsteds	elsewhere
angrep/-a	raid (n/v)
animal	animal
animalar	animals
aniversari, orsdag	anniversary
ankel	ankle
anker	anchor
anklaga	accuse
anklagad	accused
ankomad, arivad	arrived
anoda	anode
anonium	anonymous
anonse	advertisement
ansattar	employees
anselig	conspicuous
ansetta	engage
ansetta	employ
ansikt/konfrontera	face (n/v)
ansiktar	faces
ansiktskrem	face-cream
ansiktsmaske	face-pack
ansiktspuder	face-powder
ansiktsservett, neseduk	tissue (facial)
ansjantande	enchanting
ansjos	anchovy
anslutad	affiliated
anstendig	decent
anstendighet	decency
anstrengelsar, efortar	efforts
anstrengna	strain (v)
anstrengning, effort	effort
anstrengning, tipe	strain (n)
ansvarlig	accountable
ansvarlig	liable
antena	aerial
antibiotikum	antibiotic
antikk	antique
antiseptikum/antiseptisk	antiseptic
antisipera, forutsea	anticipate
antiuda, innebera	imply
antologi	anthology
anulera	cancel
anulering	cancellation
anunserad	announced
aparatt	appliance
aparatt	apparatus
aparent	apparent
aparentlig	apparently
aparta	Apart
apartament	apartment
ape	monkey
apel/a	appeal
apell/apela	appeal
apelsin/oransje	orange (n/adj)
apendiks	appendix
apera	appears
apera	appear
aperad	appeared
apering	appearance
aperitiff	aperitif
apetitlig	appetizing
apetitt	appetite
apetitveker	appetizer
aplaus	applause
aplika	apply
aplika	apply
aplikad	applied
aplikasjon	application
aplikasjon	application
apotek	pharmacy
apotek	drugstore
apoteker	pharmacist
apresiasjon	appreciation
apresiera	appreciate
aprikos	apricot
april	April
aproba	approve
aproksimadt, ungeferr	approximately
apropriera	appropriate (v)
apropriera	appropriate (v)
aprosj/a	approach
arabisk, arab	Arab
arbejd/anstrenga sej	Labor (n/v)
arbejder	laborer
arbejds-besparande	labor-saving
arbet	employment
arbet/arbeta	work
arbetad	worked
arbetande	working
arbetar/fabrik	works
arbeterar	workers
arbetsgiver	employer
arbetslös	unemployed
arbetslöshet	unemployment
areal	area
arealar	areas
Argentina	Argentina
argentinsk	Argentinian
argument	argument
argument/diskusjon	argument
arkade	arcade
arkeolog	archaeologist
arkeologi	archaeology
arkitekt	architect
arkitektur	architecture
arkiv	archives
arm/bevepna	arm
armar/vepnar	arms
armbandsur	wristwatch
armbond	bangle
armbond	bracelet
armej	Army
aroma	aroma
arr	scar (n)
arterie	artery
artikel	article
artisjokk	artichoke
artist	artist
artistar	artists
artistisk	artistic
arving	heir
asbest	asbestos
asfalt	asphalt
asiatisk	Asian
Asien	Asia
asill	asylum
asistent	assistant
asje	ash
asosiasjon, forening	Association
asosjad, forenad	Associated
asparges	asparagus
aspektar	ASPECTS
aspira	aspire
aspirin	aspirin
astma	asthma
astronomi	astronomy
asuma	assume
asumad	assumed
atakk/a	attack
ateism	atheism
ateist	atheist
atensjon	attention
atentiv	attentive
atlete	athlete
atletika	athletics
atletisk	athletic
atmosfera	atmosphere
atmosfera	atmosphere
atom	atom
atom-	atomic
atraksjon	attraction
atrakta	attract
atraktiv	attractive
att	to (in order)
aubergine	eggplant
auditorium	auditorium
august	August
auksjon	auction
Australia	Australia
australisk/australier	Australian (a/n)
automatisering	automation
automatisk	automatic
autonom	autonomous
autopsie	autopsy
autorisasjon	authorization
autorisera, berettiga	authorize
autoriterr	authoritarian
autoritet	Authority
autorr	author
av	of
avalansj	avalanche
avans/era	advance
avansert	advanced
avantasje	advantage
avdrag	instalment
aveniu	avenue
averta	avert
avfall	garbage
avfall	litter (n)
avfall	refuse (n)
avfall	rubbish
avfall-kasse	rubbish bin
avgifter	dues
avgrund	abyss
avis	newspaper
aviskiosk	newsstand
avjon	Aircraft
avjon	plane
avjon	airplane
avkasta/avkastning	yield (v/n)
avla	beget
avling	crop
avling	harvest (n)
avrejsa	depart
avrejse	departure
avrundad	rounded (adj)
avsenda	despatch
avsenda/e	dispatch (v/n)
avsides	aside
avsikt	purpose
avsiktar	purposes
avsjuelig	hideous
avslapet	easy-going
avsluta/slutt	finish (v/n)
avslutning	ending
avspark	kickoff
avstand, distans	distance
avstandsmoler	rangefinder
avtriuker	trigger
avvika	deviate (v)
avvikelse	aberration
avvikling	deviate (n)
baby	baby
bad	bath
bad-drakt	swimsuit
bada	bathe
badbalje	bathtub
badbiuksar	swimming trunks
badested	seaside resort
bagasj	baggage
bagasje	luggage
bajt	byte
baka	bake
bakbejn	backbone
baker	baker
bakeri	bakery
bakgrund	background
bakgrunn	background
bakke	hill
bakketop	hilltop
baklangs	backwards
bakliukte	tail-light
bakom	behind
bakon	bacon
bakside/uppveksa	rear (n/v)
baksmert	backache
bakterie	bacterium
bakvaskelse	slander (n)
bakverk	pastry
balans	balance
balanse/saldo	balance
balett	ballet
balje	tub
balkong	balcony
ball	ball
ballong	balloon
balsal	ballroom
bambuss	bambu
banann	banana
band speler	tape recorder
bandasj	bandage
bande, gjeng	gang
banditt	bandit
banga/banging	bang (v/n)
banga/banging	knock (v/n)
bank	bank
bankett	banquet
bankettsal	banquet-hall
banna/banning	curse
bar	saloon
bar	pub
bar	Bar
bar-tender	bartender
bar-tender	barman
bar/stang	bar
barber-börste	shaving brush
barber-krem	shaving cream
barber-masjinn	shaver
barber-sope	shaving soap
barbera (sej)	shave
barberblad	razor blade
barberkniv	razor
bare	solely
bariere	barrier
bariton	baritone
bark/göa	bark
barmhjertig	merciful
barmhjertighet	mercy
barn	child
barn, unge	kid
barn/skröna	kid (n/v)
barnar	children
barndom	childhood
barnehage	kindergarten
barnerum/planteskole	nursery
barnevakt	babysitter
barnevogn	pram
barokk	baroque
barometer	barometer
barpika	barmaid
bas	bass (mus)
basarr/retferdig	fair (n/a)
base/ra	base
baseball	baseball
basilika	basilica
basill	germ
basis	basis
bastard	bastard
batel, slag	battle
bateri	battery
bea	ask for
bebrejdelse/bebrejda	reproach (n/v)
beda	pray
bedra	deceive
bedrag	deceit
begavet	gifted (a)
begerr/begera	lust (n/v)
begina	commence
begina	begins
begina	begin
beginad	began
begining	beginning
begovad	talented
begrava	bury
begravning	burial
begravning	funeral
begrundad	based
behagelig	agreeable
behagelig	pleasing
behandlad	treated
behandling	treatment
behöv/a	need (n/v)
behövad	needed
behovar	needs
bejn	bone
bejn-sterker	splint
bejta	graze (animals)
bek	brook
bekiumer	anxiety
bekjent	acquaintance
belegring	siege
belgien	Belgium
belgisk/belger	Belgian (a/n)
beliusning	lighting (n)
belöna/belöning	reward (v/n)
belte	belt
ben	leg
benar	legs
benefit/a	benefit
benefit/era	benefit
benk	bench
benklerr	slacks
bensin pumpe	fuel pump
bensinn	petrol
bensinn	gasoline
ber	berry
bera	carry
bera	wear
bera po	depend on
berad	carried
berad	wore
berande	carrying
berej	beret
beröm/a	praise (n/v)
berömmad	famous
berömning	fame
beröra/beröring	touch (v/n)
besatt	possessed (adj)
beskatning	taxation
beskriva, deskriva	describe
beskrivad, deskrivad	described
beskrivning, deskripsjon	description
beslutad, desiderad	decided
best	best
bestefar	granddad
besteforeldrar	grandparents
bestiga/berg	mount (v/n)
bestikka	bribe
bestikkning	bribery
bestira	manage
bestirerinne/elskerinne	mistress (funct)
bestirlig	manageable
bestoa av, konsista av	consist of
besvima/svak, vag	faint (v/a)
betala	pay (v)
betalad	paid
betalbar/ventad	DUE
betaling	payment
bete	beet
beter	better
beundrer	fan, admirer
bevepnad	armed
bever	beaver
bevetad, konsjös	conscious
bevethet, konsjösnes	consciousness
bevetslös	unconscious
bevilga/stipend	grant (v/n)
bevilgad	granted
bevisa	prove
bevisad	proved
beviss	proof
bibel	Bible
bibliotekk	Library
bie	bee
biff	steak
biga	build
bigg	barley
bignad	built
bigning	building
bigningar	BUILDINGS
bikube	beehive
bil	automobile
bil	motor-car
bil	car
bilar	cars
bilde	image
bile	beetle
bilett	ticket
bilettpris	fare
bilig	cheap
bilig	inexpensive
bilisme	motoring
bilist	motorist
biljard	billiards
biljon	billion
binda	bind
binda, kniuta/slips	tie (v/n)
bindestrek	hyphen
biologi	biology
bit	morsel
bit	scrap
bit, stuke	piece
bit/bitad	bit
bita	bite
bitar	pieces
bitte litel	minute (adj)
bitter	bitter
bitumin, asfalt	bitumen
biul	abscess
biurde	burden
biuta	swap
björn	bear (n)
blad	blade
blad	leaf
blad	sheet (paper)
blad gull	gold-leaf
bladsalat	lettuce
bland, melan	among
blank	blank
blazer	blazer
bleje	diaper
bleje	nappy (diaper)
blek	pale
bleke/bleka	bleach
blekk	ink
blekna, falma	fade
bleme	blister
blere	bladder
blia	become
blia	becomes
bliande	becoming
blik	glance
blind/blinda/persienn	blind
blindgate	cul-de-sac
blitzlampe	flashbulb
bliu	lead (metal)
bliu	lead (metal)
bliva	stay
blivad	became
blivad	stayed
blixtlos	zipper
blixtlos/blixtla	zip (n/v)
blo	Blue
blo merke	bruise
blöa	bleed
blod	blood
blodkar	blood-vessel
blödning	hemorrhage
blok/era	block
blomar	flowers
blomar-butikk	flowershop
blomarbed	flowerbed
blomkol	cauliflower
blondine	blonde
blosande	gusty
blosig	windy
blosjel	mussel
bluant	pencil
bluantskarpner	pencil-sharpener
bluse	blouse
boble	bubble
bode	both
böja	flex (v)
böjelig	flexible
bok	book
bök	beech
bokar	books
bokhandel	bookstore
bokhandler	bookseller
bokk	tick (n)
bokstand	bookstand
bol/bal	ball
Bolivia	Bolivia
boliviansk/bolivian	Bolivian (a/n)
bolle	bowl
bolle	basin
bolt	bolt
bombe/bombardera	bomb
bön	prayer
bond	leash
bond	ribbon
bond/orkester	band
bönne	bean
bor/trening	drill (n)
bora/keda	bore
bora/trena	drill (v)
bord	table
bordduk	tablecloth
borde	ought to
borde	should
bordell	brothel
bordtenis	ping-pong
borgerar	citizens
borgermester	mayor
börk	birch
börste/börsta	brush
bort	away
borta	gone
bortom	beyond
boss, sjef	boss
bot	boat
bot-sted	slip (naut)
botanikk	botany
böua/böuning	bend
böuad	bent
böue	buoy
böulig	supple
bowling	bowling
bra!	all right!
brannalarm	fire-alarm
brannbrigade	fire-brigade
brannekstingerer	fire-extinguisher
brannsikker, ildfast	fireproof
brannsted	fireplace
brannungo	fire-escape
brant	steep (a)
brasiliansk/brasilianer	Brazilian
Brasilien	Brazil
bred	WIDE
bred	broad
bredara	widen
bredd, demning	embankment
bredt	width
breke	fracture
brekkjern	crowbar
bremse	brake
brenevin	liquor
brenna	burn
brennpunkt	focus
brensel	fuel
bret, planke	Board
brev/bokstav	letter
brevar/bokstavar	letters
brevpaper	notepaper
brevpaper	writing paper
brike	tray
brilar, öje-glasar	spectacles
bringa	bring
bringaberr	raspberry
bringad	brought
bris	breeze
brita/britning	break
britad	broke
britad	broken
britisk	British
bro	bridge
bröd	bread
bröd	loaf (n)
brodera	embroider
broderi	embroidery
brok	hernia
brok, upstir	fuss (n)
bröla	roar
brölop	wedding
bronkitt	bronchitis
bronse	bronze
bror	brother
brorskap	brotherhood
brorskap	fraternity
brosje	brooch
brosjure	brochure
brud	bride
brudgom	gridegroom
bruga	brew
brugeri	brewery
bruk	usage
bruk/a	use (n/v)
bruka, utilisera	utilize
bruka/brukar	uses (v/n)
brukad	second-hand
brukad	used
brukande	using
brukbar	useful
brukbar	usable
brukbar/anfal/pasa	fit
brukbarhet	usefulness
bruker	user
bruklös	useless
bruksam	useful
brulupsrejse	honeymoon
bruma	growl (v)
brun	Brown
brun	well (n)
brunette	brunette
brusing	fizz
brusk	cartilage
brust	breast
brust	bosom
brust/kiste	chest
brustholder	brassiere
brustsviming	breaststroke
brutal	brutal
bu	booth
bua	dwell
Buddhe	Buddha
buddhisk, buddhist	Buddhist
buddhism	Buddhism
budget	budget
bue	bow (bou)
bugsera/bugserbot	tug (v/n)
bugt	Bay
buka	bow (bau) (v)
bukett	bouquet
bukett/flok	bunch
buksedrakt	pants-suit
Bulgarien	Bulgaria
bulgarisk/bulgar	Bulgarian (a/n)
bun	bottom
bunke/ra	batch
bunt/a	bundle
buntmaker	furrier
bur	cage
burblera	burble
burk, konservburk	tin (can)
buro	Agency
buroar	agencies
burokrati	bureaucracy
bus	bus
busj	shrub
busk	bush
buste	bust (n)
butikk	boutique
butikk/handla	Shop (n/v)
Chile	Chile
chilensk/chilener	Chilean
Colombia	Colombia
colombiansk/colombian	Colombian
da er	That's
da, altso	then
dag	day
dagar	days
dagbok	diary
daggriu	dawn
daggriu	daybreak
dagis	daycare center
daglig	daily
dagslius	daylight
dagsorden	agenda
dal	Valley
dame	Lady
dame-toalett	powder room
dametoalett	ladies'room
dameunderkledar	lingerie
dampöl	pond
damspil	checkers
damspilbret	checkerboard
Danmark	Denmark
dans/a	dance
dansk	Danish
dansk	Dane
datamasjin	computer
dato/datera/dadel	date
datter	daughter
datter	daughter
dattersdatter, sonsdatter granddaughter
dauisk/dauist	Taoist
dauism	Taoism
daven	lazy
de	The
de er	it's
de tropikar	tropics
debatt	debate
debet	debit
dedika	dedicate
defektiv	defective
defektiv	faulty
defenda, forsvara	defend
definera	define
definisjon	definition
definitt	definite
defisit	deficit
deformad	deformed
dej	dough
deje der, dom der	those
deje er	they're
deje her, dom her	these
deje, dom	they
dejes, doms	their
dejg	batter
dejsjelvar	themselves
dek	tire (n)
dekk	deck
deklarasjon	declaration
deklarera	declare
deklarerad	declared
dekorasjon	decoration
del, porsjon	portion
del/a aksje	share
del/partera	part (n/v)
dela ut/handla med	deal (v)
dela, dividera	divide
delad, dividerad	divided
delar, partar	parts
delegasjon	delegation
delibera	deliberate (v)
deliberasjon	deliberation
delikasi	delicacy
delikatesse	delicatessen
delikatt	delicate
deling, divisjon	division
delisjös	delicious
deltaka	participate
deltaker	participant
dem	them
demand/a	DEMAND
demandar	demands
demning	dam
demokrati	democracy
demokratisk	Democratic
demolera	demolish
demolisjon	demolition
demonstrasjon	demonstration
demonstrera	demonstrate
den/som	that
denna	this
denominasjon	denomination
dentist	dentist
deodorant	deodorant
departement	Department
departement	ministry
dependent	dependent
depositum/deponera	deposit (n/v)
depresjon	depression
deprimera	depress
deprimerande	depressing
deputert	deputy
der	there
der er	there's
derfor	therefore
desember	December
desert	desert (n)
desertera	desert (v)
deserva	deserve
desidera, bestemma	decide
desinfisera	disinfect
desinfiserant	disinfectant
desirabel, önskelig	desirable
desisjon	decision
desjelv	itself
dessert	dessert
dessuten	furthermore
destina	destine
destinasjon	destination
destinie	destiny
destruksjon	destruction
desuten	Besides
det	it
detalj	detail
detaljad	detailed
detaljar	details
detekta	detect
detektiv	detective
detergent	detergent
determina	determine
determinad	determined
detrua	destroy
dets	its
deturr	detour
devaluera	devalue
devaluering	devaluation
devel, fan	devil
devijs	device
devota	devote
diabetes	diabetes
diabetiker	diabetic
diafram	diaphragm
diagnose	diagnosis
diagnosera	diagnose
diagonal	diagonal
diagram	diagram
diagram	graph
dialekt	dialect
diamant	diamond
diareje	diarrhoea
dibde	depth
dibdelös, grun	shallow
diett	diet
difera	differ
diferens, unliknes	difference
diferensar, unliknesar	differences
difteri	diphtheria
digestera	digest
digestibel	digestible
digestjon	digestion
digital	digital
dijp	deep
dijp-frijser	deepfreeze
dijsel	diesel
diktafon	dictaphone
diktat	dictation
diktator	dictator
diktera	dictate
diligens	diligence
diligent	diligent
diluta	dilute
dimme	mist
din/jer	your
dinamo	dynamo
diner	dinner
dip	baptism
dipa	baptize
diplom	diploma
diplomat	diplomat
dir	beast
direksjon	direction
direkt	directly
direkt	direct
direktad	directed
direktiv	directive
direktör	manager
direktör	director
dirigent, kondukter	conductor
dis	haze (n)
disagrea	disagree
disapera	disappear
disaproba	disapprove
disarma	disarm (intr)
disarmera	disarm (tr)
disembarka	disembark
disenteri	dysentery
disgrass	disgrace
disgusta	disgust
disgustelig	revolting
disgustelig	disgusting
disig	misty
disig	hazy
disiplin	discipline
diskontinua	discontinue
diskus	disc, disk
diskusjon	discussion
diskutera	discuss
diskutera	discuss
diskutera/argumentera	argue
diskuterad	discussed
dislokatera	dislocate
disolva	dissolve
disolvbar	soluble
disponibel	available
disposisjon	disposal
disputt/disputa	dispute (n/v)
distanse	mileage
distant	distant
distinksjon	distinction
distinkt	distinct
distribusjon	distribution
distrikt	District
disuadera	dissuade
diukerbrilar	goggles
diuktighet	skill
diurka/diurkning	worship (v/n)
divan	couch
divers	diverse
divers, ulike	various
diverse	miscellaneous
diversitet	diversity
diversjon	diversion
divine	divine
divors	divorce
divulga	divulge
döa	die
döad	died
död	death
död	dead
dödelig	mortal
dödelig	lethal
dödelig, fatal	fatal
dok/dokseta	dock (n/v)
doktor	doctor
doktor	Dr
dokument	document
dolar	dollar
dolarar	dollars
dom	judgment
domer	umpire
domer/doma	Judge
domestik	domestic
domestisk	domestic
dominant	dominant
dominera	dominate
dominering	domination
dominjon	dominion
domisil	domicile
domstol/hof	Court
dona	donate
donasjon	donation
doner	donor
dör	door
dörkloke	doorbell
dorlig	bad
dormitori	dormitory
dorn	thorn
dörvokter	door-keeper
dos	dose
dosasje	dosage
dosproklig	bilingual
dotidig	ambiguous
döv	deaf
dra til, dra ot, otstrama tighten
dra tilbaka	withdraw
drad	drawn
drad/teknad	drew
drag	trait (n)
drake	dragon
drakt, kostium/pasa	suit (n/v)
drama	drama
dramatiker	dramatist
dramatisk	dramatic
drenera/avlöp	drain (v/n)
drepa, sloa	kill
drepad, sload	killed
drik	beverage
drink/a	drink
drinkavaten	drinking-water
drinkeglas	tumbler
drinkepengar	gratuity
dristig	bold
dröm/a	dream
droning	queen
dropa/drop	drop
dropad	dropped
drosje	cab
drosjesjoför	cab-driver
druar	grapes
drukna	drown
du er	You're
du hava	you've
du sjelv, dej	yourself
du skal	you'll
du/dej	you (subj/obj)
dubel	double
dubta/dubte	doubt (v/n)
dubtesom, usiker	doubtful
duft	scent
dugg	dew
duka under	succumb
duke	doll
dukka	dive
dukke	puppet
dukketeater	puppet show
dum	mute (adj)
dum	dumb
dum	stupid
dum	silly
dum-sload	dumbstruck
dun	down (n)
dunka/dunke	thump (v/n)
dunkel, uklar	dim
durant	during
durasjon	duration
durkslag	strainer
dusin	dozen
duskrejn	drizzle
dusmörke	dusk
duve	pigeon
dverg/era	dwarf
e-post	e-mail
eble, i stand til	able
ebonie	ebony
Ecuador	Ecuador
ecuadorian	Ecuadorian
ed	oath
edelstejn, juvel	gem
ederdun	eiderdown
ederkop	spider
edukasjon	education
edukasjon	education
edukasjonal	educational
edukera	educate
efekt	effect
efektar	EFFECTS
efektiv	effective
efektiv	efficient
eföu	ivy
efter	after
efterkomer	descendant
efterligna, simulera	simulate
eftermidag	afternoon
efternam	surname
egalisera	equalize
egg	egg
egg-gule	yolk
egga, insita	incite
eggeblomme, egg-gule	egg-yolk
eggeglas	egg-cup
egnet/anfall/pasa	fit (a/n/v)
egoisme	selfishness
egoistisk	egoistic
Egypten	Egypt
egyptisk	Egyptian
eja/egen	own (v/adj)
ejekta	eject
ejekting	ejection
ejendelar	belongings
ejendelar	possessions
ejendom	estate
ejendom	property
ejer	owner
ejer	proprietor
ejk	oak
ejke	spoke (n)
ejkenöt	acorn
ekip	team
ekipera	equip
ekipering	equipment
ekivalent	equivalent
ekko	echo
ekonomi	economics
ekonomisk	thrifty
ekorner	squirrel
eksakt	exact (adj)
eksaktlig, akkurat	exactly
eksamen	examination
eksampel/tilfelde	instance
eksekusjon	execution
eksekusjoner	executioner
eksekuta	execute
eksekutiv	executive
eksekutiv	Executive
ekselent, utmerkad	excellent
eksem	eczema
eksempel	example
eksempel/tilfele	instance
eksempt	exempt
eksemsjon	exemption
eksentrisk	eccentric
eksepsjon, untak	exception
eksepsjonell	exceptional
eksersis/a	exercise
eksersise/a	exercise (n/v)
ekshala	exhale
eksibisjon/eksibera	exhibit (n/v)
eksil	exile
eksistens	EXISTENCE
eksistens/vesen (creature)being (n)
eksistera	exist
eksisterande	existing
eksitta	excite
eksittande	exciting
eksittning	excitement
eksklama	exclaim
eksklamasjon	exclamation
ekskludera	exclude
eksklusiv	exclusive
eksklusivlig	exclusively
ekskursjon	excursion
ekskusa, unsjulda	excuse (v)
ekskuse, unsjuldning	excuse (n)
eksoss/eksossa	exhaust (n/v)
eksotisk	exotic
ekspandera	expand
ekspedisjon	expedition
ekspeditör	shop assistant
ekspektasjon, forventning expectation
ekspelera	expel
ekspenditure	expenditure
ekspens	expense
ekspens	expens
ekspensiv	expensive
eksperiens/a, erfaring/a	experience
eksperienslig, erfaren	experienced (adj)
eksperiment/era	experiment
eksperimentar	experiments
ekspert	expert
eksplisit	explicit
eksplodera	explode
eksplojt/era	exploit (n/v)
eksplora	explore
eksplosiv	explosive
eksplosjon	blast
eksplosjon	explosion
eksponera	expose
eksponering	exposure
eksport	exportation
eksport/era	export (n/v)
eksportar	exports
eksposisjon	exposition
ekspresa	express (v)
ekspresad	expressed
ekspresjon	expression
ekspress	express (a)
ekspress	special delivery
ekstase	ecstasy
ekstase	ecstasy
ekstendera	extend
ekstendera	extend
ekstenderad	extended
ekstensiv	extensive
ekstensjon	extension
ekstent	extent
eksternell	external
ekstingera	extinguish
ekstra	extra
ekstradisjon	extradition
ekstraditera	extradite
ekstraordinari	extraordinary
ekstravagant, overdrivad	extravagant
ekstrem	extreme
ekstrem	extreme
eksuberant	exuberant
ekte	genuine
ekteman, man	husband
ekvator	equator
elabora	elaborate (v)
elaborad	elaborate (a)
elastisk	elastic
elastiskhet	elasticity
eldre	elderly
eldre	elder
elefant	elephant
eleganse	elegance
elegant	elegant
eleksjon	election
elektriker	electrician
elektrisitet	electricity
elektrisk	Electric
elektronik	electronic
elementar	elements
eler	or
eler	nor
elers	else
elers/anenledes	otherwise (conj/adv)
elev	pupil (school)
elfenbejn	ivory
elg	moose
elimina	eliminate
elska/elske	love (v/n)
elskad	loved
elskad	beloved
elsker	lover
elskling	sweetheart
elv	elf
elve	eleven
elvete	eleventh
emalje	enamel
emaljert	enamelled
embarasa	embarrass
emblem	emblem
emigrasjon	emigration
emisjon, utsending	emission
emosjonal	emotional
emosjonn, kensle	emotion
en	an
en	a
en anan	Another
en bit	slightly
en gang	once
en/man	one (num/prn)
enar	ones
end-pip	nozzle
enda	ends
endad	ended
endast, bare	merely
ende	end (purpose)
ende, slutt	end
endelig	at last
endosera	endorse
energi	energy
energisk	energetic
eneste	sole (a)
eneste/bare/men	Only (adj/adv/conj)
enestoande, singulerr	singular
enfasis	emphasis
eng	meadow
engangs-	disposable
engel	angel
engelsk	English
engelsk mil	mile
engelsman	Englishman
England	Britain
England	England
engslig	worried
engslig, redd	afraid
enhet	unit
enhet	unity
enhetar	units
enighet, agrejment	agreement
enigme	riddle
enigme	enigma
enke	widow
enkel	single
enkling	widower
enligt	according
enn	than
ennu/likvel	yet (adv/conj)
ennu;likvel/stile	still (adv/adj)
enorm	gigantic
enorm	immense
enorm	vast
enorm	huge
enorm	enormous
ensidig	one-sided
ensiklopedie	encyclopedia
ensom	lonely
enstemmig	unanimous
enten	either
enten/heler	either
entitlad	entitled
entreprenör	contractor
entusiasme	enthusiasm
entusiastisk	enthusiastic
enver	everybody
enver	everyone
envia/envie	envy (v/n)
enviös	envious
envis	stubborn
epidemi	epidemic
epilepsi	epilepsy
epilog	epilogue
episode	episode
eple	apple
epos/episk	epic (n/a)
er	is
er	are
er ike	isn't
erad	been
erad enig, agrejad	agreed
erend	errand
ergo	hence
erkebiskop	archbishop
erklerad	stated
erklering	statement
erkleringar	Statements
erlig	honest
erlighet	honesty
erme	sleeve
ert	pea
esel	donkey
esel/derierr	ass
esensjel	essential
esensjel	essential
esensjellig	essentially
eskadrile	squadron
eskalator	escalator
eske/boksa	Box (n/v)
eskorta	escort (v)
eskorte	escort (n)
esplanade	esplanade
essay	essay
essens	essence
estim/a	esteem (n/v)
estuari	estuary
eta	eat
etablera	establish
etablerad	established
etelig	edible
eter	ether
eternell	eternal
eternitet	eternity
etikett/etiketera	label (n/v)
Etiopien	Ethiopia
etiopisk/etioper	Ethiopan
euro	euro
Europa	Europe
Europa	Europe
europeisk	European
europeisk	Eueropean
evakuera	evacuate
evangelium	gospel
even om/emelertid	though
even/jemn	even (adv/adj)
event	event
eventar	events
eventir	adventure
eventiur	fairytale
eventuell, endelig	eventual
evidens, bevis	evidence
evident	evident
evolusjon	evolution
fabel	fable
fabrikant	manufacturer
fabrikera	manufacture
fabrikk	factory
fajanse	faience
fakla, lomelikt	torch
faks, telefaks	fax
fakt	fact
fakt	fact
faktar	facts
faktar, data	data
faktisk	factual
faktisk	actual
faktisk	Actually
faktisk, realt	really
faktor	factor
faktorar	factors
faktura	invoice
fakultet	faculty
fakultet/talent	faculty
falaferdig	ramshackle
fald, söm	hem (n)
fall/a/efteror	fall
fallad	fell
fals	false
fals/forfalsning	fake (a/n)
falsk/blöffer	phoney (a/n)
familij	family
familijar	families
famös, berömad	famous
fanatisk	fanatical
fanga	capture
fanga/gripa	catch
fangevokter	jailer
fantasi	fantasy
fantastisk	fantastic
fantome	phantom
far	father
far	dad
fare	danger
farfar, morfar, bestefar	grandfather
farga av	discolor
farga/farge	dye (v/n)
farge/farga	color (n/v)
farlig	dangerous
farmakologi	pharmacology
farmor, mormor, bestemor	grandmother
farse	farce
farvel, adjö	good-bye
fasade	façade
fase	phase
fasilitejar	facilities
fasilitetar	facilities
fasinera	fascinate
fasjisme	fascism
fasjist/fasjistisk	fascist (n/a)
fast	fixed
fastland	mainland
fastning	stronghold
fatijg	fatigue
favör/favöra	favor (n/a)
favor/isera	favor
favoritt	favorite
favörlig	favorable
fe	fairy
feber	fever
feberaktig	feverish
februar	February
federasjon	federation
fedreland	fatherland
fejl	error
fejl	mistake (n)
fejl, defekt	fault
fejla	fail
fejla	err
fejla	fail
fejlad	failed
fejlaktig	mistaken (adj)
fejlfri, perfekt	faultless
feld	field
feldar	fields
felle/fella	trap (n/v)
feltseng	camp-bed
fem	Five
feminin	feminine
femte	fifth
femti	fifty
femton	Fifteen
femtonte	fifteenth
fender	fender
fengsel	jail
ferd, rejse	journey
ferdig	finished
ferie, heligdag	holiday
ferje	ferry
fermenta	ferment
fernisse/fernissa	varnish (n/v)
fersken	peach
fertilisera	fertilize
fertiliserer	fertilizer
fest	feast
festa	fasten
festener	fastener
festival	festival
festlig	festive
festning	fortress
fet/fett	fat (a/n)
fetiliserer, gödsel	manure
fetme	fatness
fett/smöra	grease (n/v)
fettet	greasy
fettholdig	fatty
fi!	shame!
fiasko	Failure
fiber	fiber
fiend	enemy
fig	Fig
figur	figure
figurar	figures
fik/a	slap (n/v)
fiksjon	fiction
file	rag
filipiner	Filipino
filla	fill
fillad	filled
fillning	filling (n)
film	movie
film/a	film (n/v)
filmavis	newsreel
filosof	philosopher
filosofi	philosophy
filter	filter
fin (adj)/böd/a (n,v)	fine (a/v)
fina	finds
fina	find
finad	found
final, endelig	final
finalig, endelig	finally
finansar	finances
finansiera	finance (v)
finansjel	fiscal
finansjel	financial
fingerar	fingers
fingeravtrukk	fingerprint
fingerborg	thimble
finhaka	mince
finke	finch
Finland	Finland
finlander	Finn
finsk	Finnish
fint!	okay!
fir	Four
firmar	companies
firmar	firms
firte	fourth
firti	forty
firton	fourteen
firton dagar	fortnight
firtonte	fourteenth
fisiker	physicist
fisiologi	physiology
fisisk	physical
fisk/a	fish (n/v)
fiskebejn	fishbone
fisker	fisherman
fiulla möblar	upholster
fiulning	stuffing
fjeder	feather
fjederkre	poultry
fjeldal	glen
fjer	spring (n, mech)
fjern	far-off
fjern	far
fjern	faraway
fjernest	furthest
fju	few
flagg	flag
flamingo	flamingo
flamme	flame
flanell	flannel
flaske	bottle
flaske	flask
flaskehals	bottleneck
flass	dandruff
flat	flat
flek	blot
flek/a	stain (n/v)
flek/sted	spot (n)
flekad	spotted (adj)
flekfri	spotless
flekfri	stainless
flekk	speck
flera	several
flia	flee
fliga	fly (v)
fligtur, fligning	flight
flintstejn	flint
fliugfelt	airfield
fliuglinja	airline
fliugverdinne	stewardess
fliuta	float
fliutande	fluent
fliutande	fluid
flod	River
flod/a	flood (n/v)
flodbred	river bank
flodbred	riverside
flok	herd
flokk	flock (n)
florissa	flourish (v)
florister	florist
flote	navy
flote	fleet (n)
flote	raft
flöute	flute
flue	fly (n)
flurisj	flourish (n)
foa, reseva	receive
foa/bli	GETS
foa/blia	GET
foad, obtenerad	obtained
foad, resevad	received
foad/bliad	got (act/pass)
foajé	foyer
foande	getting
föda, mat	food
födad	born
foder	lining
födsel	birth
födsel	childbirth
födselsdag	birthday
fogel	fowl
fogelar	Birds
fogelhandler	poulterer
föla	feel
fölad/filt	felt (v/n)
fold, rinke/rinka	crease
folda/fold	fold (v/n)
fölga	FOLLOWS
fölga	follow
fölgad	followed
fölgande	following
fölgande	subsequent
folie	tinfoil
föling, kensle	feeling
fölingar, kenslar	feelings
fölinglös	numb
folk	folk
folk	people
folkedans	folk-dance
folkevise	folksong
folklore	folklore
fond	FUND
fondar	funds
fonetisk	phonetic
fopengar/underhol	allowance
for	for
for de mest	mostly
for...sidan	ago
forakta	despise
foran	AHEAD
forandra	alter
forandra/forandring	change (v/n)
forandrad	changed
forandring, alterasjon	alteration
forandringar	changes
förat	because
forbetra	improve
forbetrad	IMPROVED
forbetring	improvement
forbida	forbid
forbinda	join
forbindad	joined
forbipaserande	passer-by
forbruker	consumer
forbrutt/a	forfeit (n/v)
forbund	League
forbunds	federal
fordampa, evapora	evaporate
fordel	advantage
fordelaktig	advantageous
fordervad	stale
före	before
före, tidligare	before (adv)
foreldrar	parents
forell	trout
forena	unite
forenad	United
Forenad Statar	United States
forenadlig	jointly
Förenta Statar/os	US
Forentar Nasjonar	UN
förer	Leader
förerar	leaders
förerskap, lederskap	leadership
forfader	ancestor
forfallen	dilapidated
forfallen	overdue
forfalsa	fake (v)
forfalsa	falsify
forfalska	forge (v)
forfalska/falsk	counterfeit v/a
forfölga	pursue
forfölga	chase
forfriska	refresh
forfriskning	refreshment
forgasser	carburetor
forgilt	gilt (a)
forgoande	preceding
forgoande, previös	previous
forgrunn	foreground
forhandla	negotiate
forhandling	negotiation
forhands	beforehand
forhandsbetalad	prepaid
forheksa	bewitch
forhenvarande	former
forhöd	forehead
forhöja	raise
forhöjad	raised
forklara	explain
forklarad	explained
forklaring	explanation
forkledning/forkleda sej	disguise (n/v)
forkorta	shorten
forkortning	abbreviation
förkrigs-	pre-war
forlanga/anklaga/ladning	charge
forlangad	charged
forlata/permisjon	leave
forlatande	leaving
forlegga	mislay
forlenga	lengthen
förlora	lose
förlorad	lost
förloring	loss
forlovad/optatt	engaged
forlovede	fiancé/e
forlovning/forpliktning	engagement
form/a	shape
form/forma	form
formad	formed
formalitet	formality
forman	chairman
formann	foreman
formar	forms
formell	formal
formiddagsmat, lunsj	lunch
formiunder	guardian
förmögen	wealthy
formörkning	eclipse
formula	formula
forniua	renew
fornöud	contented
fornuftig	sensible
foror, vor	spring (season)
fororsakad	caused
forplikta	oblige
forpliktant	obliging (a)
forreder, trejtor	traitor
forrederi	treason
forret	hors-d'oeuvre
forretnings senter	shopping center
forsamling	assembly
forsejl	foresail
forserad	forced
forsida	front
forsikra	assure
forsikring	insurance
forsiktig	cautious
forsiktig	careful
forsiktig	carefully
forsiktighet	caution
forsina/forsining	supply (v/n)
forsjuna/möblera	furnish
forskreka	frighten
forskrekad	frightened
forskrekelig	frightful
forsök/a, pröva	attempt
forsöka	try
forsökad/prövad	tried
forsökande/prövande	trying
forsökning	research
forsomna sej	oversleep
forstad	suburb
forstads	suburban
förste	first
förste etasje	ground floor
Förste Mosebok	Genesis
förstehelp	first-aid
försteklass	first-class
försteklass	first-rate
forstira	disturb
forstiring	disturbance
forstiring	unrest
forstman	forester
forstoa	understand
forstoad	understood
forstoand	wits
forstoing	understanding
forstoppad	constipated
forstoppning	constipation
forstörra	enlarge
forstörring	enlargement
forstua/forstuing	sprain (v/n)
forsvar, defense	defense
forsvinna	vanish
fort	Fort
fort	fort
fort-körande	speeding (adj)
fort-köring	speeding (n)
forta sej/forte	hurry (v/n)
fortak	undertaking
fortaka	undertake
fortau	sidewalk
fortelling	story
fortellingar	stories
fortid/fortids	past
fortredd	mischief
fortredlig	mischievous
fortsetta	proceed
fortunad, liuklig	fortunate
fortunatt, gusjebnisk	lucky
fortune, liuke	fortune
fortvilad	desperate
forum	forum
forveksla	mistake (v)
forverv	acquisition
forvundra	amaze
forvundring	amazement
fot	foot
fotar	feet
fotball	football
fotballkamp	football game
fotbol	soccer
fotbrems	foot-brake
fotganger	pedestrian
fotganger-overgang	crosswalk
fotograf	photo
fotograf/fotografera	photograph (n/v)
fotografer	photographer
fotografi	photography
fotokopi	photocopy
fotspesjalist	chiropodist
föudal	feudal
foul	ugly
fragment	fragment
frak	coat
fraksjon	fraction
framför,för	before (prep)
framgoande	successful
frankad	postpaid
Frans	France
fransjise	franchise
fransk	French
fransk	French
franskman	Frenchman
fransman	Frenchman
frase	phrase
frase-bok	phrasebook
frasjill	fragile
frata	deprive of
fraude	fraud
fred	Peace
fredag	Friday
fredelig	peaceful
frekvens	frequency
frekventlig	frequently
frem	forth
frem	forward
frembringa	generate
fremed	strange
fremling, ukenad personn	stranger
fremover	onwards
fremst	foremost
fremstoande	distinguished
fri/gratis	free
fria	release (v)
frihet	freedom
frihet	liberty
frijöring	emancipation
frijsa	freeze
frijsa punkt	freezing point
frijsad, frosen (lit)	frozen
frikenande	acquittal
friksjon	friction
frikt/frikta	fear (n/v)
frikta/frikt	dread (v/n)
friktelig	dreadful
frimerka, stempla	stamp (v)
frimerke	postage stamp
frimerke, stempel	stamp (n)
frinsje	fringe
frisering	hair-do
frisk	Fresh
frisör	barber
frisör	hairdresser
fritid	leisure
frö	seed
froga	ASK
froga/froga ut	question (v)
frogad	asked
frogande	asking
frogar	questions
frogar/problemar	issues
fröken	Miss
frokost	breakfast
fron, ifron	from
frontlius	headlight
frosk	frog
frost	frost
frue	mistress (title)
frukt	fruit
fruktbar	fertile
frukthage	orchard
fruktlös	vain
fruktsaft/kriusja	squash (n/v)
fuktig/het	damp
fulblods-	thoroughbred
fulenda	accomplish
full	Full
fullig	fully
fulstendig/iutra	utter (adj/v)
fundamental	fundamental
fundasjon	foundation
funklende	sparkling
funksjon/a	function (n/v)
furiöse	furious
furo	groove
futur, fremtid/fremtidig	future (n/a)
gafel	fork
gafel/dela sej	fork (n/v)
gal, sinnsiuk/sint	mad
gal, sinnsjuk, tukig	crazy
galge	gallows
galle	gall (n)
galle	bile
galle blere	gall bladder
galleri	gallery
gallestejn	gallstone
galopp/galopa	gallop (n/v)
galumfera	galumph (v)
gam	vulture
gamal	ancient
gangart	gait
gange, tempo	pace
gangvej	footpath
ganska, rettare	rather
ganske/prefera	rather (adv/v)
garanter	guarantor
garantij	guarantee
garasje	garage
garderob/kledskap	wardrobe
garderobe	cloakroom
garn	yarn
garten, hage	garden
gartner	gardener
gas	GAS
gase	gauze
gastar	guests
gasterum	guest-room
gatar	Roads
gatar	streets
gate	street
gate, vej	road
gatekruss	crossroads
gave, presang	gift
gavl	gable
geant	giant
gebiss	false teeth
gejtebuk, gejt	goat
gelender	rail (n)
gelender	railing
generasjon	generation
generator	generator
genesis	genesis
geografi	geography
geografisk leksikon	gazetteer
geologi	geology
geometri	geometry
gespa	yawn
gestikulera	gesticulate
geverr	rifle
geverr	gun
gevir	antlers
gifta sej	marry
giftad	married
gifte, mariasj	marriage
gigabajt	gigabyte
gigla/e	giggle (v/n)
gikt	gout
gilia	shelter (v)
gimnastikk	gymnastics
gimnastikker	gymnast
gimnastikksal	gymnasium
ginekolog	gynecologist
gir	gear
gis/na	guess
gitarr	guitar
giva	gives
giva	give
givad	gave
givad	given
givande	giving
gjelle	gill
glad	joyful
glad	cheerful
glad, liuklig	happy
glamorös	glamorous
glas	Glass
glasera	glaze (v)
glat	slippery
glat, even, smul	smooth
gleda sej	rejoice
glede	gladness
glede	delight
glede, fröjde	joy
gledsom	delightful
glema	forget
glemsom	forgetful
glia	glide
glia	slide (v)
glia	skid
glia	slip (v)
glidefli	glider
glidning	slide (n)
glim	splendor
glimer/glimera/hurtstela	flash (n/v/v)
glimrande	splendid
glimt	glimpse
glis/a	grin (n/v)
global	global
globus	globe
glöda/glöd	glow (v/n)
glori	glory
gloriös	glorious
gnia	rub
gnist	spark
go	go
go fottur	hike
goa	goes
goa in	enter
goa ned	descend
goa om bord	embark
goa over	cross
goad	went
goad in	entered
goande	going
gods tog	freight train
golf	golf
golf, vik	gulf
golfbane	golf-links
golfbane	golf-course
golfkölle	golf-club
gondol	gondola
gong	aisle
gord	yard
gorm/a	rant (n/v)
gos	goose
gosehud	gooseflesh
gosj/ukonvenjent	awkward
gra	Gray
grad	degree
grad, klase	grade (n)
gradera/klasifisera	grade (v)
gradient	gradient
gradua/graduad	graduate (v/n)
graduell	gradual
grafisk	graphic
grahund	greyhound
gram	gram
gramatikk	grammar
gramatisk	grammatical
grammofon	record player
gran	fir tree
granatkaster	mortar (weapon)
grand	grand
granitt	granite
grapefrukt	grapefruit
gras, iunde	grace
grasiös	graceful
gratis	gratis
gratulera	congratulate
gratulerar	congratulations
grav	tomb
grav/seriös	grave (n/a)
grava	dig
gravera	engrave
gravering	engravering
gravid	pregnant
gravitet	gravity
gravlund	cemetery
gravstejn	gravestone
gravsten	tombstone
grea/kam	comb (v/n)
grekisk/grek	Greek
Grekland	Greece
gren	bough
gren	branch
grense	border
grense	boundary
grense	frontier
gress	grass
gresshoppe	grasshopper
gressplen	lawn
greve	earl
grevinne	countess
grevskap	County
grill/grilla	grill (n/v)
gripa	seize
gripa/grep	grip (v/n)
gripa/grep	grasp (v/n)
gripad	caught
gripbar	tangible
gris	pig
grisk	avaricious
grisk	greedy
grod	greed
gröft	ditch
grön	Green
grönhus	greenhouse
grönsak	vegetable
grönsakar	greens
grönsakhandler	greengrocer
gros/brutto	gross (a)
groshandel	wholesale
gross	gross (n)
grota	weep
grota/skrika	cry
grotte	cave
grotte	grotto
grov	coarse
grov/total/gross (144)	gross
grund	ground
grundar	grounds
grundlig	thorough
grunlegande	basic
grunn-low, konstitusjon	constitution
grunnar	grounds
grup	group
grupar	groups
grupera	classify
grus	grit
grus	gravel
grusom	cruel
gruvarbejter	miner
gruve	pit
gruve	mine (n)
gruvedrift	mining
gu-troande	credulous
Gud	God
gud, bra	good
gudfar	godfather
gudine	goddess
gudinne	goddess
guide	guide
guidehund	guidedog
gul	yellow
guliunt	good-humored
gull	gold
gullen	golden
gullgruve	goldmine
gullsmed	jeweler
gullsmed	goldsmith
gulsot	jaundice
gulv/etasje	floor/storey
gumi	gum
gummi	rubber
gumudig	good-natured
gumudig	good-tempered
gurgla	gargle
gurmej	gourmet
gutt	lad
guvernör	governor
guvilje	goodwill
habitable	habitable
habitat	habitat
habite	habit
habituell	habitual
hagl	hail (n)
haika	hitchhike
haiker	hitchhiker
hake	chin
hakka/kotelett	chop
hakke	pick-axe
hall	hall
hallo	hello
hals	neck
hals-nakke	nape of neck
halsbond	collar
halsbran	heartburn
halskejde	necklace
halv	half
halv-	semi-
halv-vejs	halfway
halvera	halve
halvsirkel	semicircle
halvtid	half-time
hammer	hammer
hamp	hemp
han	him
han	He
han er	he's
han havad/han skul	he'd
han-	male (a)
hand	hand
hand-brems	hand-brake
handar	hands
handarbejt	needlework
handbok	handbook
handduk	towel
handel	business
handel/handla, biuta	trade
handelsforbid	embargo
handelsman	tradesman
handelsman, biuter	trader
handful	handful
handjern	handcuffs
handkrem	hand cream
handla/handling, akt	act
handlabag	shopping bag
handlagad	hand-made
handled	wrist
handling/jöring	deed
handskrift	handwriting
handverk	handicraft
handveske	handbag
hane	cock
hans	his
hanske	glove
hantruk	handshake
har	hair
harbörste	hairbrush
hard-hödad, obstinat	obstinate
hard/svor, difikult	hard (1/2)
hare	hare
haret	hairy
harklip	haircut
harlakk	hair spray
harmful, skadelig	harmful
harmlös, uskadelig	harmless
harmoni	harmony
harnett	hairnet
harolje	hair-oil
harpe	harp
hartörker	hair-dryer
hasselnöt	hazelnut
hast	haste
hastighet, farten	speed
hastímeter	speedometer
hat	hatred
hata/hat	hate (v/n)
hatt	Hat
haug	pile
haug	heap
haug	mound
hauk	hawk
hav	ocean
hava	has
hava (irreg 1)	have
havad	had
havad ike	hadn't
havande	having
haven	haven
havfrue	mermaid
havn	harbor
havn	port
havn	seaport
havnarbejter	docker
havre	oats
hebraisk	Hebrew
hebreisk	Hebrew
hede/upvarma	heat
hedensk/hedning	pagan (a/n)
hedning/hedensk	heathen (n/a)
hefta	staple (v)
heftaparatt	stapler
heftklamer, stapelvara	staple (n)
heftstift	thumbtack
hegre	heron
hei	heath
heisa/heise	hoist (v/n)
hejl	heel
hejs	elevator
hekk	hedge
hel	whole
hel, komplet	entire
hela	heal
helbreda/kur	cure (v/n)
helgen	St
helgen	saint
helgensjrin	shrine
helig	holy
helig	holy
helig, sakrad	sacred
heligbröde	sacrilege
hella	pour
helm	helmet
help, asistans	assistance
help/a	aid
helpa	assist
helpa/help	help (v/n)
helpad	helped
helper	helper
helpsom	helpful
helsa	salute (v)
helsa	greet
helse	Health
helsesam	wholesome
helsig	healthy
helsning	greeting
helt	quite
helt	hero
helt	altogether
helt	wholly
helt, kompletlig	entirely
helvede	hell
helvete	hell
hem	home
hemar	homes
hemelagad	home-made
hemlengsel	homesickness
hemoroidar	hemorrhoids
hemoroidar	piles
henda, sjea	happen
henda, sjea	occur
hendad, sjead	occurred
hendad, sjead	happened
hendelse	happening
hendelse, sjening	occurrence
hendig	handy
henförad	rapt
henföring	rapture
henga	hang
hengad	hung
hengbro	suspension bridge
hengeköue	hammock
hengelos	padlock
henger	hanger
hengover	hangover
hengsel	hinge
hengslar	suspenders
henta, innbringa	fetch
her	here
herberge	hostel
herder	shepherd
hereditarig	hereditary
herefter	henceforth
herr	mister
herre	gentleman
herre-ekvipering	haberdashery
hertelig	cordial
hertug	duke
hertugine	duchess
hes	hoarse
hesita	hesitate
hest	horse
hest-redik	horseradish
hestar	horses
hesteg	stirrup
hestekraft	horsepower
hestesjo	horseshoe
het, varm	hot
hetbalje	hot tub
heteroseksuell	heterosexual
hette	hood
hexe	witch
hierarki	hierarchy
hikke	hiccup
himel	heaven
himel	sky
hindra	hinder
hindra	impede
hindring	obstacle
hindring	impediment
hisig	hot-tempered
hisig	quick-tempered
historie	history
historiker	historian
historisk	historic
historisk	historical
hiugiene	hygiene
hiugienisk	hygienic
hiukler	hypocrite
hiukleri	hypocrisy
hiuklersk	hypocritical
hiule	shelf
hiulest	homage
hiumne	hymn
hiuresgast	tenant
hiusterisk	hysterical
hjerte	heart
hjerte-klapp	palpitation
hjertelig	hearty
hjertelös	heartless
hobby	hobby
hobe/hoba	hope (n/v)
höd	head
höd-	main (a)
höd-, storsta	main
höd-kvarter	headquarters
hödland	headland
hödledning	mains
hödsaklig	mainly
hödtorment	headache
hödvej, hödgata	thoroughfare
hofte	hip (n)
hofte/hip	hip (n/a)
hofteholder	girdle
hög, long	tall
högland	uplands
högt	aloud
höide	height
höj	hay
höj	high
höjare	higher
höjare	upper
höjarskola	college
höjast	HIGHEST
höjde	altitude
höjfeber	hayfever
höjlig	highly
höjvaten	high tide
hokkey	hockey
Holand	Holland
holda	hold
holda	keep
holda fölge med	keep up with
holda sej borte fron	keep away from
holdad	held
holdad	kept
holdande	keeping
holding	holding
hölja	enfold
Holland	Holland
hollander, nederlander	Dutchman
hollandsk, nederlandsk	Dutch
homosexuell, gej	homosexual
hon	She
hon havad/hon skul	she'd
hon-	female
höne	hen
honing	honey
honor/honora	honor (n/v)
honorable	honorable
honorar, gebiur	fee
hons	her
hopeful	hopeful
hoplös	hopeless
hoplöshet	despair
hopp	leap (n)
hopp/a, sprenga	jump (n/v)
hoppa	leap (v)
hoppa	hop (v)
hoppa over	skip
hoppe	mare
höra	hear
hörad	heard
hörbar	audible
hore	whore
höring	hearing
horisont	horizon
horisontal	horizontal
horn	horn
hörne	corner
horrible	horrible
horror	horror
hospitable	hospitable
hospital	Hospital
hospital	hospital
hospitalitet	hospitality
höst	autumn
hostasj	hostage
hostill	hostile
hot	threat
hota	threaten
hotell	Hotel
höure	right-hand
höutaler	loudspeaker
hov	hoof
hövding	chieftain
hovmester	headwaiter
hovmodig	haughty
hud	skin
hul	hollow
hule	cavern
hull	hole
hulrum	cavity
humid	humid
humiditet	humidity
humilitet	humility
humle	hops (n)
hummer	lobster
humor	humor
humorös	humorous
humörr	mood
humörr	temper (n)
humpad	bumpy
hund	dog
hundar	dogs
hundra	hundred
Hungaria	Hungary
Hungarsk	Hungarian
hunger	hunger
hur	how
hurtig	rapid
hurtig	fast
hurtig	rapidly
hurtig(t)	quickly
hurtig, forhastet	hasty
hurtig, snab	fast
hurtig, snab	quick
hus	House
hus-animal	pet (n)
hus-help	maid
hus-help	housemaid
husa/gasthut	lodge (v/n)
husar	houses
husarbejd	housework
husbot	houseboat
husholderske	housekeeper
husholdning	housekeeping
huska, rememora	remember
huska, rememora	recollect
huskad, rememorad	remembered
husmor	housewife
husning	housing
husstand	household
hustru	wife
hutta	cottage
hutte	hut
hvila/hvile, rest	rest (v/n)
hvilehem	rest home
hvilsom	restful
i	in
i de siste, niulig	lately
i melantid	meanwhile
I morgen	tomorrow
i natt, i kvel	tonight
I sista	lately
i sted (av)	Instead (of)
iakta/armkloke	watch
iaktad	watched
iaktande	watching
idag	today
idej	idea
idejal	ideal
idejar	ideas
identifika	identify
identifikasjon	identification
identisk	identical
identitet	identity
identitetskort	identity card
idiom	idiom
idiomatisk	idiomatic
idiot	idiot
idiotisk	idiotic
idol	idol
ignisjon	ignition
ignorera	ignore
igor	yesterday
ijenn	again
ike	not
ike de mindre	Nevertheless
ikon	icon
ild/skjuda	fire
ildig	fiery
ildsted	hearth
ildstik	match (n)
ildstik-eske	matchbox
ileluktande	smelly
illegal	illegal
iluminasjon	illumination
iluminera	illuminate
ilusjon	illusion
ilustrasjon	illustration
ilustrera	illustrate
ilvilig	malicious
imaginari	imaginary
imaginasjon	imagination
imigrant	immigrant
imigrasjon	immigration
imigrera	immigrate
imitasjon	imitation
imitera	imitate
immediad	immediate
immediadt	immediately
imot	towards
impakt	impact
impaundera	impound (v)
imperium	empire
impertinens, frekhet	impertinence
impertinent	impertinent
implement/a	implement (n/v))
impolitt	impolite
impolitt	rude
imponera	impress
imponerande	imposing
imponerande	impressive
import/era	import (n/v)
importans, viktighet	importance
importör	importer
impotens	impotence
impotent	impotent
impresjon	impression
imprisona	imprison
imprisoning	imprisonment
improbabilitet	improbability
improbable	improbable
improvisera	improvise
impuls	impulse
impulsiv	impulsive
imunitet	immunity
imunn	immune
in i	into
inadekvat	inadequate
inakurat	inaccurate
inblandad	involved
indefinitt	indefinite
indeholda, kontejna	contain
indeholdad, kontejnad	contained
indeks	index
indemnitet	indemnity
independens	independence
independent	Independent
India	India
indiferent	indifferent
indigestjon	indigestion
indignasjon	indignation
indikator	indicator
indikera	indicate
indikerad	indicated
indirekte	indirect
individ, enkeltperson	individual (n)
individuelar	individuals
individuell, enkelt	individual (adj)
Indonesien	Indonesia
indonesisisk/indoness	Indonesian
indre	inner
indre	internal
indulgens	indulgence
indulgera	indulge
industri	industry
industriös	industrious
industrisk, industriell	industrial
inebrierad	drunk
inefisjent	inefficient
ineksperienslig, uerfaren inexperienced
inevitable	inevitable
infant, spedbarn	infant
infanteri	infantry
infeksjon	infection
infeksjös	infectious
inferior, dorligare, nedreinferior
infinitiv	infinitive
infirmari	infirmary
infisera	infect
inflamasjon	inflammation
inflammabel	inflammable
inflasjon	inflation
inflatable	inflatable
inflatera	inflate
inflitningsrik	influential
influens/era	influence (n/v)
influensa	influenza
influensa	flu
informasjon	information
informera	notify
informera	inform
informerad	informed
infraksjon	offence (stress2)
infraröd	infrared
ingang	entry
ingang	entrance
ingang klave	latchkey
ingangspengar	entrance-fee
ingefer	ginger
ingen	none
ingen	nobody
ingen	no one
ingen	no (adj)
ingeniör	engineer
ingensteds	nowhere
ingenting	nil
ingenting	Nothing
ingrediens	ingredient
inhabitbar	inhabitable
inhabiter	inhabitant
inhabitera	inhabit
inhala	inhale
inhalasjon	inhalation
inheritans	inheritance
inheritera	inherit
inhold	contents
inisjal	initial
inisjal/a	initial (a,n/v)
inisjativ	initiative
injeksjon	injection
injeksjonsprute	syringe
injekta	inject
inkapable	incapable
inklinad	inclined (a)
inklinasjon	inclination
inkline/a	incline (n/v)
inkludande	including
inkludera	include
inkluderad	included
inklusive	inclusive
inkompetent	incompetent
inkomplet	incomplete
inkomst	income
inkomst-skat	income tax
inkonveniens	inconvenience
inkonvenient	inconvenient
inkorekt	incorrect
inkvira	inquire
inkviring	inquiry
inkvisitiv	inquisitive
inneholstabell	table of contents
innen	indoors (adv)
innendörs	indoor (adj)
innerst	inmost
innover	inwards
innside	inside
innsikt	insight
innsjipning	embarkation
innsjö	lake
innvalid	disabled
inom	within
inordna/reka	file (v)
inpakning	packing
insea	discern
insea/realisera	realize
insead/realiserad	realized
insekt	bug
insekt	insect
insektmiddel	insecticide
insens	incense
insensitiv, ufölsom	insensitive
inserta	insert
insident	incident
insidental	incidental
insignifikant	insignificant
insistera	insist
inskripsjon	inscription
inskriva, registera	register
insolens	insolence
insolent	insolent
insomnia	insomnia
inspeksjon	inspection
inspektör	inspector
inspirera	inspire
inspisera	inspect
instalasjon	installation
instalera	install
instant, öjeblikk/instant instant (n/a)
instantelig, öjeblikkelig instantly
instinkt	instinct
institusjonar	institutions
institutt/institutera	institute (n/v)
instruksjon	instruction
instruktera	instruct
instruktiv	instructive
instruktör	instructor
instrument	instrument
instrument-bord	dashboard
insufisjent	insufficient
insult/era	insult (n/v)
insurans, forsikring	insurance
insurera, forsikra	insure
intakt	intact
intek	earnings
intelekt, forstand	intellect
intelektuell	intellectual
inteligens	intelligence
inteligent	intelligent
inteligent, klok	clever
inteligent, klok	witty
intendent	warden
intendera	intend
intens	intense
intensitet	intensity
intensjon	intention
intensjonell	intentional
intensjonell	deliberate (a)
interesant	interesting
interesar	interests
interese/interesera	interest (n/v)
intereserad	interested
interfera	interfere
interfering	interference
interim/melantid	interim
interior, inside	interior
interkonekta	interconnect
interkurs	intercourse
intermisjon	intermission
internasjonal	international
interpreta	interpret
interpreter	interpreter
interrogasjon	interrogation
interrogera	interrogate
interrupsjon	interruption
interrupta	interrupt
interseksjon	intersection
intervall	interval
intervena	intervene
intervju/a	interview (n/v)
intestine	intestine
intim	intimate (a)
intoksikerad	intoxicated (a)
intrigge	intrigue (n)
introduksjon, presentasjonintroduction
introdusera, presentera	introduce
invadera	invade
invalid	invalid (n)
invasjon	invasion
invensjon	invention
inventer	inventor
inventera	invent
inventiv	inventive
inventorie	inventory
inverta	invert
invertad	upside-down
investera	invest
investering	investment
investigga	investigate
invisible	invisible
invitasjon	invitation
invitera	invite
involvera	involve
iordna/samling/fil/a	file
Irak	Iraq
irakisk/irakier	Iraqi
Iran	Iran
iransk/iranier	Iranian
irasible	irascible
iritera	annoy
iriterande	annoying
iritering	annoyance
Irland	Ireland
irlender	Irishman
irlendsk	Irish
ironi	irony
ironisk	ironical
irregular	irregular
irreparable	irreparable
irrevokable	irrevocable
irritabel	irritable
irritera	irritate
is-kold	freezing
isbre	glacier
iser	especially
iskrem	icecream
islam	Islam
islamisk	Islamic
Island	Iceland
Islending	Icelander
Islendsk	Icelandic
isolasjon	insulation
isolasjon	isolation
isolator	insulator
isolera	insulate
isolera	isolate
ispose	icebag
Italien	Italy
italiensk/italiener	Italian
item	item
itinerant	itinerant
itinerari, reiserute	itinerary
iulle-	woolen
iutersta	utmost
iver	zeal
ivrig	eager
ivrig	zealous
ivrig, urolig	anxious
ja	Yes
jade	jade
jakke	jacket
jakt/a	hunt (n/v)
jamre/jamra	moan (n/v)
janitor	janitor
januar	January
Japan	Japan
japansk/japaner	Japanese
jazz	jazz
je	I
je er	am
je er	I'm
je ha	I've
je havad/je skul	I'd
je skal	I'll
jeans	jeans
jede	pike
jejer	hunter
jekk	jack (n)
jeld	debt
jema	hide (v)
jenforena	reunite
jenom	through
jenomblöta, blöta	soak
jenombora	pierce
jenomljusig	translucent
jenomsnit, averasj	average
jenomsnitlig	medium (a)
jer sjelvar	yourselves
jern	iron
jernvarar	hardware
jernveg, jernbane	railroad
jernveg, jernbane	railway
jernverk	ironworks
jersej	jersey
jest	yeast
jeting	wasp
jevn	even
jius	shudder
jo, sandelig, virkelig	Indeed
job	job
jobar	jobs
jobig	hard work (adj)
jod	iodine
jöde	jew
jödisk	jewish
jödisk	Jewish
jokkey	jockey
jolle	dinghy
jöra	does
jöra	do
jöra distinksjon	distinguish
jöra ike	doesn't
jöra ike/jör ike	don't
jöra imunn	immunize
jöra tjik	thicken
jöra vund, skada	hurt (vt)
jörad	made
jörad	did
jörad	done
jörad ike	didn't
jörande	doing
jörbar	doable
jord	earth
jord, grunn	ground
jord-, landbruks-	agrarian
jord/sojla	soil (n/v)
Jordanien	Jordan
jordansk/jordanier	Jordanian
jordber	strawberry
jordbruk, agrikultur	agriculture
jordmor	midwife
jordsjelv	earthquake
jubileum	jubilee
jubla	shout for joy
judaism	Judaism
jude	Jew
judisk	Jewish
juksa	cheat
jul	Xmas,Winter Solstice
jul	wheel
jul	Xmas
jula	spank
juli	JULY
juling	spanking
julstol	wheelchair
julvagn	wheelbarrow
jumper	jumper (clothing)
jungfru	virgin
juni	JUNE
junior	junior
junior	Jr
juri	Jury
jurisdiksjon	jurisdiction
jurnalist	journalist
jurnalistikk	journalism
just	just
justera	adjust
juvenil, ungdoms-	juvenile
kabaret	cabaret
kabel	cable
kabin/hute	cabin
kafeinn	caffeine
kafeinn-fri	decaffeinated
kafej	café
kafejnn-fri	decaffeinated
kafeteria	cafeteria
kaffe	coffee
kagge	keg
kai	quai
kaj	quay
kajakk	kayak
kake	cake
kaki	khaki
kala	call
kala/kalar	calls
kalad	named
kalad	called
kalanam	nickname
kalelse	summons
kalender	calendar
kalk/lind/limett	lime
kalkon	turkey
kalkulator	calculator
kalori	calorie
kalsium	calcium
kalv	calf
Kalvinism	Calvinism
kalvköt	veal
kamaksel	camshaft
kamej	cameo
kamel	camel
kamera	camera
kamgarn	worsted
kamp/kempa	struggle
kampagna	campaign
kampanje	campaign
kampjon	champion
kan (irreg 1)	can
kan ike	cannot
kan ike	can't
kanad ike	couldn't
kanad, skul kana	could
Kanada	Canada
kanadensisk/kanadenser	Canadian
kanal	canal
kanarifogel	canary
kandidat	candidate
kanel	cinnamon
kanin	rabbit
kano	canoe
kanser	cancer
kansje	perhaps
kansje, moske	Maybe
kant	edge
kant	verge
kantine	canteen
kaos	chaos
kaotisk	chaotic
kapable	capable
kapasitet	capacity
kapelann	chaplain
kapell	chapel
kapital	capital
kapitalisme	capitalism
kapitalist	capitalist
kapitel	Chapter
kapitulasjon	capitulation
kapitulasjon, upgivning	surrender (n)
kapitulera, giva sej upp	surrender (v)
kappe	cloak
kapra	hijack
kaprer	hijacker
kapsel	capsule
kaptejn	captain
kar	guy
karaff	carafe
karakter	character
karakterisera	characterize
karakteristisk	characteristic
karamell	caramel
karantene	quarantine
karat	carat
kardinal	cardinal
kariere	career
karnaval	carnival
karote	carrot
karpe	carp
karpenter	carpenter
karpete	carpet
karri	curry
kart	map
kartong	carton
kartotek/reke	file (n)
karusell	merry-go-round
kasavalvt	vault (bank)
kasera	discard
kaserer	cashier
kaserne	barracks
kasino	casino
kasjmir	cashmere
kast/a	cast
kasta	toss
kastanje	chestnut
kastanjebrun	auburn
kat	cat
katakombe	catacomb
Katalansk/katalann	Catalan
katalog	catalogue
Katalunya	Catalonia
katarr	catarrh
katastrofal, desaströs	disastrous
katastrofe	catastrophe
katastrofe, desastre	disaster
katedrall	cathedral
kategori	category
katolisism	catholicism
katolsk	Catholic
kaviar	caviar
kedelig	boring
keiserlig, riks-	imperial
kejle	kettle
kejser	emperor
kejserine	empress
keks	cracker
kela med	cuddle
Kelt	Celt
keltisk	Celtic
kemij	chemistry
kemisk	chemical
kempa/kamp	fight
kempande	fighting
kenguru	kangaroo
kennel, hundehus	kennel
kennemerke	feature
kenner	connoisseur
kenskap	knowledge
Kenya	Kenya
kenyansk/kenyer	Kenyan
kephest	hobby-horse
ker	dear
keramikk	pottery
keramikk	ceramic
kereste	darling
kerne	core
kerosene	kerosene
kerre	cart
kertegna	pet (v)
kertegna	caress
kertel	gland
keve	jaw
kijka	peep
kilde	well (n)
kilo	kilogram
kilobajt	kilobyte
kilometer	kilometer
Kina	China
Kina	China
kinesisk	Chinese
kinesisk/kiness	Chinese (a/n)
kinin	quinine
kinn	cheek
kinnbejn	cheekbone
kino	cinema
kinsjegar	sideburns
kiosk	kiosk
kirkar	churches
kirke	church
kirke-servant	sexton
kirkegord	graveyard
kirseber	cherry
kirurg	surgeon
kirurgie	surgery
kitla	tickle
kittel	cauldron
kiuling	chicken
kiundig	skilled
kiundig	skilful
kius/a	kiss (n/v)
kjöl	keel
klang/klanga	sound
klapa/aplaudera	clap
klar over	aware
klar/ridda	clear
klarjöra	elucidate
klarjöra	clarify
klarlig	clearly
klassar	classes
klasse	Class
klassekamerad	classmate
klasserum	classroom
klassisk	classical
klatra/klatring	climb
klausul	clause
klave	key
klavebord	keyboard
klavehull	keyhole
klebig	sticky
klebtejp	tape (adhesive)
kleda av sej	undress
kleda po sej	get dressed
kleda sej om	change clothes
kleda sej/kledning	dress (v/n)
kledar	clothes
kleft	chasm
klejre	clay
klesplagg	garment
klient	client
klima	climate
klinikk	clinic
klipa/gunga	rock
klipe/junga	rock (n/v)
klippe	cliff
kliufte/kliufta	wedge (n/v)
klo	claw
kloakk	sewer
klöe/klöa	itch (n/v)
klöft	cleft
klöft	gorge (n)
kloke	bell
kloke	clock
kloken	o'clock
klor	chlorine
kloster	cloister
kloster	abbey
klöuva	split (v)
klöver	clover
klovn	clown
klubb, forening	Club
klubbe	cudgel
klukke/a	chuckle
klump	lump
klumpad	lumpy
klutsj/grep	clutch
knaka	tap (verb)
knap	scarce
knap/knapa	button (n/v)
knaphet	scarcity
knaphet	shortage
knapnol/-era	pin (n/v)
knapt	scarcely
kne	knee
knekt	knave
knela	kneel
kneskol	kneecap
knirka	creak
kniv	Knife
knop	bud
knott	knob
knuke	knuckle
knul/a	fuck (n/v)
knuland	fucking (adj)
knura	grumble
knute/knuta	knot (n/v)
knuttneve	fist
kö	queue
koagulera	coagulate
kode	code
kofert	trunk (box)
koinsida	coincide
koinsidens	coincidence
koka	cook (v)
koka/biul	boil
kokain	cocaine
köken	kitchen
kokonöt	coconut
koktejl	cocktail
kol	cabbage
kolapsera	collapse
kold	cold
koldbord	buffet
kole	toffee
kolega	colleague
kolektiv	collective
köleskap	refrigerator
kolidera	collide
kölig	chilly
kölig/kul	cool (a/slang)
köligskap	fridge
kolisjon	collision
kolisjon/kolidera	crash
kolje	haddock
kolonell	colonel
koloni	colony
kolonne	column
kolonne	column
kolor-blind	color-blind
kolor/a	color
kolorad	colored
kolorik, fargerik	colorful
koma	come
koma	comes
koma	coma
komad	came
komand/era	command
komanda/e	command
komande	coming
komande, mötande	oncoming
komander	commander
kombat/era	combat
kombinasjon	combination
kombinera	combine
komedie	comedy
komentera/koment	comment
komers	Commerce
komersiel	commercial
komfort	comfort
komfortabel	comfortable
komiker	comedian
komisjon	Commission
komisk	comic
komisk	funny
komitej	Committee
komma	comma
kompakt	compact
kompakt disk	compact disc
kompanie/firma	Company
kompanjon	companion
komparasjon	comparison
komparativ	comparative
komparera	compare
komparerad	compared
kompasjon, medlidanhet	compassion
kompass	compass
kompatible	compatible
kompelera	compel
kompensasjon	compensation
kompensera	compensate
kompetera	compete
kompetera	compete
kompetisjon	competition
kompetitör	competitor
komplejna	complain
komplejnt	complaint
kompleks	complex
kompleksjon	complexion
komplesjon	completion
komplet/era	complete
kompleterad	completed
kompletlig	completely
komplikera	complicate
komplikerad	complicated
kompliment/era	compliment
komplott/plotera	plot (n/v)
komponentar	components
komponera	compose
komponist	composer
komportera sej	behave
komportera sej dorligt	misbehave
komposisjon	composition
komprehensiv	comprehensive
komprisera	comprise
kompromisera	compromise (v)
kompromiss	compromise (n)
komputer	computer
komunikasjon	communication
komunikera	communicate
komunisme	communism
komunist	Communist
komuter	commuter
kön, sekse	sex
kondisjon	condition
kondisjona/r	conditions
kondisjonell	conditional
kondisjoner	conditioner
kondom	condom
kondukt/a	conduct
kondukt/a	conduct
kondukta en sak	plead
konduktad	conducted
koneksjon, lenke	connection
konekta, lenka	connect
konfeksjons-	ready-made
konferens	conference
konferens	conference
konfesa	confess
konfesjon	confession
konfidens	confidence
konfidens	confidence
konfidensiell	confidential
konfident	confident
konfirma	confirm
konfirmasjon	confirmation
konfiskera	confiscate
konflikt	conflict
konfrontera	face (v)
konfusa	confuse
konfusa	confuse
konfusjon	confusion
konfusjon	confusion
konge	king
kongelig	royal
kongerike, rike	kingdom
Kongo	Congo
kongress	Congress
konjakk	cognac
konkera	conquer
konkerer	conqueror
konkering	conquest
konklusjon	conclusion
konkret	concrete
konkuranse	contest (n)
konkusjon	concussion
konmemorasjon	commemoration
könn	gender
könns-	genital
könns-sjukdom	venereal disease
konotasjon	connotation
konsakra	consecrate
konsekvens	consequence
konsentrasjon	concentration
konsentrera	concentrate
konsentrera	gather (intr)
konsepsjon	conception
konsept	concept
konsern/a	concern
konsernad	concerned
konsernande	concerning
konsert	concert
konservativ	conservative
konsesjon	concession
konsidera	consider
konsiderabel	considerable
konsiderad	considered
konsiderande	considering
konsiderasjon	consideration
konsiderat	considerate
konsil	council
konsis	concise
konskript	conscript
konspira	conspire
konstant	CONSTANT
konstatera	ascertain
konstruera	construct
konstruksjon	CONSTRUCTION
konsul	consul
konsulat	consulate
konsultasjon	consultation
konsultera	consult
kontakt	contact
kontejner	container
kontemporarisk	Contemporary
kontempte	contempt
kontinent	continent
kontinental	continental
kontinua	continue
kontinua	keep on
kontinuad	continued
kontinual	continual
kontinualig	continually
kontinuande	continuing
kontinuerlig	continuous
konto/raportering	account
kontor	Office
kontorist	clerk
kontrakt	contract
kontraseptiv	contraceptive
kontrast	contrast
kontribuera	contribute
kontribusjon	contribution
kontroll/kontrolera	control
kontroversiell	controversial
konturr	contour
konveniens	convenience
konvenient	convenient
konvensera	convince
konvent	convent
konvertera, omvenda	convert
konviksjon	conviction
konvikte/a	convict
konvolutt	envelope (n)
konvulsjon	convulsion
kooperasjon	cooperation
kooperativ	cooperative
koordinasjon	coordination
köpa	buy
köpa	purchase
köpad	bought
köper	purchaser
köper	buyer
kopi/era	copy
kopla av	switch off
kopla po	switch on
koplingsbord	switchboard
köpman	merchant
köpman	shopkeeper
kopp	cup
kopper	copper
koppor	smallpox
kor	Corps
kor	choir
köra fort	speed (v)
köra/vej/köretur	drive (v/n/n)
körad	drove
korall	coral
korde	cord
körebane	roadway
korekt/korigera	correct
korektnes	correctness
körer, sjoför	driver
korespondanse	correspondence
korespondent	correspondent
korespondera	correspond
koridor	corridor
korigering, koreksjon	correction
korint	currant
kork	cork
korketrekker	corkscrew
korn	grain
korn	corn
kornoker	cornfield
korporasjon	corporation
korps	corpse
korpulent	corpulent
korpulentt, tik, kraftig	stout
korsett	corset
korsfesta	crucify
korsfestning	crucifixion
kort	short
kort	brief
kortine	curtain
kortt-giver/forhandler	dealer
korupsjon	corruption
korupt	corrupt
koselig	cozy
kosmetikk	cosmetics
kost	broom
kost/a	costs
kostnad, pris/kosta	cost
köt	meat
kotelett	cutlet
kotonn	cotton
kött	flesh
köue	bunk
kovarde	coward
kovardelig	cowardly
kovera/kover	cover (v/n)
koverad	covered
kraba	crawl
krabe	crab
kraft, makt/energi	power
kraft/fors/era	force
kraftar/forsar	powers
kraftar/forsar	forces
kraftverk	power station
kragebejn	collarbone
kram/a	hug (n/v)
krampe	clamp
krampe	cramp (n)
kran	crane
kran	tap (faucet)
krangel	row [rau] n
krangel/krangla	quarrel (n/v)
krater	crater
krav/kreva	claim
kredit	credit
kreditor	creditor
kreditt/gu-skriva	credit
krem	cream
krematera	cremate
krematering	cremation
kreva, rekira	require
krevad, rekirad	required
krevar	CLAIMS
kribe	manger
kridsa/kors	Cross
krig	war
krigsjip	man-of-war
kriket	cricket
krime, brot	crime
kriminalitet	criminality
kriminell	criminal
krimpa	shrink
krimpa-fri	shrinkproof
krimson	crimson
kripa	creep
krise	emergency
krise	crisis
krisis	crisis
Krist	Christ
kristall	crystal
kristen	Christian
Kristiansk/kristian	Christian
Kristus	Christ
krit	ckalk
kritiker	critic
kritikk	criticism
kritisera	criticize
kritisk	critical
kriuke	crutch
kriuter	spice
kriutrad	spicy
kriutrad	spiced
krok	hook
kroke	crow
kroket	crooked
krokke	pitcher
krokodille	crocodile
krom	chromium
kronblad	petal
krone/krona	crown
kronisk	chronic
kronologisk	chronological
krop	body
kropar	bodies
krosjeja	crochet
kruke	jar
krull/a	curl (n/v)
krullad	curly
krus	mug
krusade	crusade
krusifiks	crucifix
krutt	gunpowder
ku	cow
Kuba	Cuba
kubansk/kuban	Cuban
kube	log
kube	cube
kul	coal
kule	gown
kule	bullet
kule	frock
kulkasta	upset (v)
kultivera	cultivate
kultiverad	cultured
kultur	culture
kultural	cultural
kuna/makt	might (adv/n)
kunde	customer
kunst	Art
kunstar	Arts
kunstig	artificial
kupele	dome
kupert	hilly
kupong	coupon
kupong	voucher
kurasje	courage
kurasjös	courageous
kuriositet	curio
kurs	course
kurs/kursus/löp	course
kursar	courses
kursivskrift	italics
kursted	spa
kurt	card
kurtjös, höflig	courteous
kurv	basket
kurv	hamper (n)
kurvad	curved
kurve	curve
kurve	turning
kusine	cousine
kusjon	cushion
kusme	mumps
kust	seaside
kust/glida	Coast (n/v)
kustodie	custody
kustodier	custodian
kuvera	cover
kvadrat/-isk	SQUARE (n/a)
kvalifikasjon	qualification
kvalifisera/... sej	qualify (tr/intr)
kvalifiserad/kompetent	qualified (1/2)
kvalitet	quality
kvantitet	quantity
kvart, kvarter	quarter
kvarterlig	quarterly
kvav	stuffy
kveg	cattle
kvejte	halibut
kvela	choke
kvelsmat	supper
kveri/-a	query (n/v)
kviksölv	mercury
kvilt	quilt (n)
kvina	woman
kvinar	women
kvist	twig
kvita sej med	dispose of
kviz	quiz (n)
kvote	quota
labirint	labyrinth
labirint	maze
laboratorium	laboratory
laborforening	trade union
lag	layer (n)
lag	team
laga, jöra	make
laga, jöra	makes
lagande, jörande	making
lager	depository
lager/hava po lager	Stock
lager/lagra	store
lagerplass/stasjon	depot
lagom	just right
lagra	store (v)
lagring	storage
lagune	lagoon
laken	sheet (bed)
lakk	lacquer
laks	salmon
laksativ	laxative
lam	lamb
lam, halt	lame
lama	paralyse
lamentable	lamentable
lampe	lamp
lampesjerm	lampshade
land	country
land/landa	land (n/v)
landar	countries
landbruk/a	farm
landbruker	farmer
landbrukshus	farmhouse
landerett	launderette
landgang	gangway
landlig	rural
landmerke	landmark
lands-	rustic
landsby	village
landskap	landscape
landskap	scenery
landsman	countryman
langkule	robe
langs	along
langsom	slow
langsomt	slowly
lanterne	lantern
Laos	Laos
lap	tag (n)
lapell	lapel
lappe/lappa	patch (n/v)
laringitis	laryngitis
last	freight
last, frakt	cargo
last/a	load (n/v)
lastbil	lorry
lastbil	Truck
lasterum	hold (n)
lastkaj	wharf
Latinamerika	Latin America
latinamerikansk	Latin American
latinsk	Latin
latitud	latitude
latter	laughter
lav	low
lavare/senka	lower (a/v)
lavland	lowlands
le'er	leather
lea	laugh
led	joint (anat)
leda, stira/ledning	lead (v/n)
ledad	headed
ledande	leading
legad	laid
legal, retslig	legal
legalisasjon	legalization
legasjon	legation
legat	legacy
legga, plasera, seta	lay
legitimitet	legitimacy
legitimm	legitimate
lej av, trötad av	tired of
lej for	sorry (a)
leja	hire (rent)
leja (ut)	lease (v)
leja/leje	rent (v/n)
leje-kontrakt	lease (n)
lejeboer	lodger
lejkman	layman
lejr/kampera	camp
lejsa/lejsad	read (pres/past)
lejsalampe	reading lamp
lejsasal	reading room
lejsning	reading (n)
leka/lekasje	leak (v/n)
lekig	leaky
leksjon	lesson
lektur	lecture
lem	limb
lena sej	lean (v)
lengde	length
lengsel	longing (n)
lengta	yearn
lengting	yearning (n)
lenke/forbinda	link (n/v)
lepar	lips
lepepomade	lip balm
lepestift	lipstick
leprosie	leprosy
ler	Clay
lera	teach
lera sej	learn
lerad	learned
lerad	taught
lerande/lere	teaching
lerande/lerning	learning
lerbok	textbook
lerer	schoolteacher
lerer	teacher
lerer	schoolmaster
lererar	teachers
lerke	lark
leselig	legible
let	easy
leta efter	hunt for
lethet	facility
lethet	ease
letlig	easily
letning, help, relief	relief
leva	lives (v)
leva-rum, stue, parlör	living-room
leva/nde; direkt	live (v/a;tv)
levabröd	livelihood
levad	lived
levande	alive
levande	living
lever	liver
lever	lever
levera	deliver
levering	delivery
levetid	lifetime
li	shelter (from wind)
li, bakke	hillside
liabilitet	liability
libanesisk/libaness	Lebanese
Libanon	Lebanon
liberal	liberal
liberasjon	liberation
Liberia	Liberia
liberiansk/liberian	Liberian
liga/liva/lövn	lie
lik	alike
lik	similar
lika/lik/liksom/liksom	like (v/a/c/p)
likad	liked
like	equally
like-sindad	like-minded
likeso	likewise
likevel	however
likhet	equality
likhet	resemblance
likhet	semblance
likhet, similaritet	similarity
likna	resemble
liknande	similar
likörr	liqueur
likris	liquorice
likvel	However
likvid/e	liquid a/n
lilje	lily
lilla	mauve
lim	paste
lim	glue
limit/a	limit (n/v)
limitad	limited
limonade	lemonade
lindetre	limetree
linen	linen
linjar	lines
linje	line
linse	lens
lion	lion
liontann	dandelion
lisensa	license (v)
lisense	licence (n)
lisna (po)	listen (to)
list/a	list (n/v)
listener	lisner
lita po/tro	trust (v/n)
litel barn	toddler
litel barn	tot
litel pake	packet
litel, liten, smo (pl)	little
liten, litel, smo (pl)	small
litenare	smaller
liter	liter (litre)
literarisk	literary
literatur	literature
liudisk	noisy
liudpote	silencer
liudt, höu	loud
liuga/lögn	lie (tell a) (v/n)
liukas	succeed
liuke	happiness
liun	lightning
liung	heather
liuskaster	searchlight
liuske	groin
liuspere	lightbulb
liuspere	lightbulb
liusröd	pink
liustig	jolly
liustorn	lighthouse
liv	life
liv-vakt	bodyguard
livbelte	lifebelt
livlig	lively
livlig/kölig	brisk
livmoder	womb
livsforsikring	life insurance
ljudband	tape (recording)
ljus/ljus-	light (n/a)
lod	lot
loda	solder (v)
lode-bolt	soldering-iron
loft	attic
löfta/hejs	lift (v/n)
logikk	logic
logisk	logical
lojall	loyal
lök	onion
lokal	local
lokalisera	locate
lokaliserad	located
lokasjon	location
lokasjon	location
löke	loop (n)
lokk	lid
lokomotiv	locomotive
lome	pocket
lome-törkle	handkerchief
lomebok	pocketbook
lomelikt	flashlight
lon	mortgage
lon	loan (n)
lön	wage
lön	wages
lona bort	lend
London	London
long	long
longare	longer
longbuksar	trousers
longdegrad	longitude
lönn	maple
löp/ras	race
löpa	run
löpa	runs
löpad	ran
löpande/strömande	running
lor	thigh
lord, herre	Lord
lord-hus	mansion
lord-hus	manor house
lördag	Saturday
lös	loose
los, slus	lock (n)
los/a	lock (n/v)
losa	lock (v)
losa op	lock up
lösapengar	ransom
losji	lodgings
losjon	lotion
lösna	loosen
lösna	detach
lot os	let's
lota	let
lotteri	lottery
lov	law
lovar	laws
lovaten	low tide
lovlig	lawful
luben	plump
lubrikasjon	lubrication
lubrikera	lubricate
ludikrös	ludicrous
lufer/vandra	tramp (n/v)
luft	air
luft-	pneumatic
luft-höd	airhead
luft-kondisjonering	air conditionin
luftfilter	air filter
lufthavn	airport
luftig	airy
luftpost	airmail
luftsiuke	air sickness
lufttet	airtight
luka	shut
lukad	closed
luke/ruga ut	hatch (n/v)
lukka	close (v)
luksuriös	luxurious
luksus	luxury
lukt, stink	smell (n)
lukta, stinka	smell (v)
lumbago	lumbago
luminös, liusande	luminous
lund	grove
lunge	lung
lunkenvarm	lukewarm
lunsj	luncheon
lus	louse
lust	zest
lustjakt	yacht
madam	madam
madam	Mrs
madrass	mattress
magasinn	warehouse
magasinn	storehouse
magazinn	magazine
mage	gastric
mage	belly
mage	stomach
mager	lean (a)
mageverk	stomach ache
magi/magisk	magic (n/a)
magiker	magician
magistrat	magistrate
magnetisk	magnetic
magnifikk	magnificent
mais	maize
maj/mo	may (cal/v)
major	major
majoritet	majority
makrell	mackerel
maksimum	maximum
maktelös	powerless
maktig	powerful
mala	grind
malaria	malaria
Malaysia	Malaysia
malaysier	Malay
malaysisk	Malaysian
maler	painter
maleri	painting
maleri, ilustrasjon	picture
maleriar	pictures
malignant	malignant
maling/mala	paint (n/v)
malm	ore
malnutrisjon	malnutrition
malplasera	misplace
malplaserad	misplaced (a)
malut-tala	mispronounce
mamall	mammal
mammut	mammoth
man	man
manar	men
mandarin	tangerine
mandarinn	mandarin (n)
mandat	mandate
mandel	almond
manekinn	mannequin
manerar	manners
manet	jellyfish
mange	many
mangel	deficiency
mangel	shortcoming
mangel/mangla	lack (n/v)
mangel/mangla	lack
manglande	missing
mani	craze (n)
manikiurr	manicure
mans	man's
mans	one's
mansjett	cuff
manskap	crew
mantenera	maintain
mantenering	maintenance
mantenering	upkeep
manuell/handbok	manual (a/n)
manuskript	manuscript
marg	margin
margarinn	margarine
marine-	naval
maritimm	maritime
marked	market
markera/merke	mark (v/n)
markise	awning
marmelade	marmalade
marmor	marble
marokansk/marokan	Moroccan
Maroko	Morocco
mars	March
marsj/era	march (n/v)
marsvin, forsöks-animal	guinea-pig
martell	mallet
martirr	martyr
masasje	massage (n)
masasjera	massage (v)
masjin/motor/lokomotiv	engine
masjineri	machinery
masjinn, aparatt	machine
masjinskrivad	typewritten
masjinskriver	typist
maska/nett	mesh (v/n)
maskara	mascara
maske/ra	mask (n/v)
maskulin	masculine
masörr	masseur
masse	mass
masse	bulk
massiv	massive
mast	mast
mat forgiftning	food poisoning
mata/mate	feed
matbit	snack
matematikk	mathematics
matematisk	mathematical
materia	matter
material	material (n)
material/fiulla	stuff (n/v)
materialar	materials
materiar	matters
materie	pus
materiell	material (a)
matolje	salad oil
matrimonial	matrimonial
matrimonie	matrimony
matsjej	tablespoon
matt	dull
matur	mature
maturitet	maturity
maturr	ripe
matvarar	foodstuffs
matvarar	groceries
matvareforretning	grocer's
matvarehandler	grocer
maur	ant
mausoleum	mausoleum
med	with
med de ström	downstream
med rajt	rightly
medaljonn	medal
medan	whilst
medan, durant	During
medan/stund	While (adv/n)
medbrotsling	accessary
medeland	message
mediatera	mediate
mediaterer	mediator
medisinisk doktor	physician
medisinn	medicine
medisinsk	medical
meditera	meditate
mediteransk	mediterranean
medlem	member
medlemar	members
medlemskap	membership
medmindra	unless
megabajt	megabyte
megler	broker
meieri	dairy
mej	me
mej	myself
mejsel	chisel
mekaniker	mechanic
mekanisk	mechanical
mekanisme	mechanism
mektig	mighty
mel	flour
melan	between
melanetasje	mezzanine
melankoli	melancholy
melanman	intermediary
melanspil	interlude
melantid	meantime
melk	milk
melkaktig	milky
melkman	milkman
melodi	melody
melodi	tune
melodisk	tuneful
melodrama	melodrama
melon	melon
memorandum	memo
memori	memory
memori-verdig	memorable
memorial	memorial
memorisera	memorize
men	but
mena, betia	mean
mena/medel	means (v/n)
menad	meant
meneskhet, humanitet	humanity
mengde	lot
mengde, folkemengde	crowd
mening	meaning
meningslös	meaningless
meningslös	senseless
menisklig/meniske	human (a/n)
meniu	menu
menneskehet	mankind
menstruasjon	menstruation
mental	mental
mer	more
merit/era	merit (n/v)
merka	sense (v)
merka/notijs	notice (v/n)
merkad	marked
merkbar	noticeable
merke/brenmerke	brand
merkelig, vundrelig	queer
mesing	brass
meslinger	measles
messe	Mass
mest	most
mester	Master
mesur-band	tape-measure
mesur/a	measure
mesurad	measured
metal	Metal
meter	meter (meas.)
meterar	yards
metoda	method
metodar	methods
metodisk	methodical
metrisk	metric
mexikansk/mexikaner	Mexican
Mexiko	Mexico
middag	midday
middag, tolv kloken	noon
midelaldersk	medieval
midje	waist
midnatt	midnight
midsomer	midsummer
midte	midst
midte	Middle
migrene	migraine
migrera, vandra	migrate
mike	very
mike	much
mikrofon	microphone
mikrovogovn	microwave oven
miksa	mix
miksad	mixed
mikser	mixer
miksing	mixture
milar	Miles
mild	mild
mild	gentle
mile	mile
milestejn	milestone
militerr	military
miljö	milieu
miljö	environment
miljon	million
miljonerr	millionaire
min	mine
min	my
min herr	Sir
mindre	less
minerall	mineral
miniatiur	miniature
minimum	minimum
minimum	minimum
ministerr	Minister
mink	mink
minka/nedgang	decrease
minor, mindre	minor
minoritet	minority
minska, forminska	lessen
minska, subtrakta	subtract
minst	least
minus	minus
minutt	minute
minuttar	minutes
mir	bog
mirakel	miracle
mirakulös	miraculous
misbruk	abuse
misbruk	misuse (n)
miserable	miserable
miserr	misery
misfornöud	discontented
misforstoa	misunderstand
misforstoing	misunderstanding
mishaga	displease
misjon	Mission
mislika/mislike, antipatiedislike (v/n)
mista	miss (v)
mistanke, mistro	suspicion
Mister	Mr
misteriös	mysterious
misterium	mystery
mistiker	mystic
mistiker	mystic
mistinksam, mistinkad	suspicious
mistro/a	mistrust (n/v)
misunna/misunne	grudge (v/n)
miude	myth
miudisk	mythical
miunt	coin
miunte	mint (n)
miutini	mutiny
mjuk	soft
mjukjöra	soften
mobil	mobile (adj)
möblar	furniture
moda	fashion
mödad	met
mode	manner
möde	meeting
modelera/forma	model (v)
modell/manekeng	model (n)
moderatt	moderate (adj)
moderera	moderate (v)
moderne	modern
moderne	fashionable
modest	modest
modesti	modesty
modifisera	modify
modig	plucky
modig	brave
modist	milliner
mohair	mohair
moka	mock
moke	gull
mokeri	mockery
mökk	muck
mol	goal
mol	goal
möl	moth
mola-instrument	gauge (n)
molar	molar
mölber	mulberry
moler	meter (guage)
mölle	mill
möller	miller
molman	goalkeeper
molo	jetty
moltavle	target
moltid	meal
moment	moment
momentarig	momentary
monad	month
monadar	months
monadlig	monthly
monark	monarch
monarki	monarchy
monasteri	monastery
mondag	Monday
mone	moon
monesjin	moonlight
monitor/monitera	monitor (n/v)
monolog	monologue
monopol	monopoly
monoton	monotonous
mönster/motiv	pattern
montanerr	mountaineer
montann	mountain
montanös	mountainous
monter	showcase
monument	monument
moped	moped
moped	motorbike
mor	mother
moral/-sk	moral (n/adj)
moralitet	morality
mord	assassination
mord/a	murder
morder	murderer
morfin	morphine
morfin	morphia
morgen	morning
morgenkope	dressing-gown
mörk	dark
mörke	gloom
mörkig	gloomy
moro	fun
mortel	mortar (grind)
mosaikk	mosaic
mose	moss
mosja	mash
mosjon	motion
moskej	mosque
moskito	mosquito
moste	must
mot	against
mot	toward
mot de ström	upstream
möta	meet
möta/möte	encounter (v/n)
mote	fashion
motell	motel
motiv	motive
motor	motor
motorbot	motorboat
motorsikkel	motorcycle
motorvej	motorway
motorvej	turnpike
motsaga	contradict
motsagand	contradictory
motsat	contrary
motte	may (subj, wish)
motto	motto
motvile	antipathy
motville	aversion
mova	move
movad	moved
movande	moving
movbar	movable
movment	movement
mufler	muffler
mug	mildew
mugen	mouldy
mugge	jug
mulesel	mule
muletfisk	mullet
mulig	feasible
mulig	realizable
mulig	possible
mulighet	possibility
muligt	possibly
multiplikasjon	multiplication
multiplisera	multiply
mund	mouth
mundvaten	mouthwash
munisipalitet	municipality
munisipall	municipal
munk	monk
munter	merry
munter/homosexuell	gay
munterhet	mirth
munterhet	gaiety
mur, vegg	wall
murar, veggar	walls
murer	bricklayer
murstejn	brick
murverk/mura	mortar (wall) (n/v)
mus	mouse
museum	museum
musikalsk/musikall	musical (a/n)
musiker	musician
musikk	Music
musjrom	mushroom
muskattnöt	nutmeg
muskel	muscle
muskulös	muscular
muslim	Muslim
musselin	muslin
mustard	mustard
mustasj	moustache
mut	roach
mutonn	mutton
mutuell	mutual
nabo	neighbor
nabo-	next-door
nabolag	neighborhood
naiv	naive
naken	naked
naken	bare
naken	nude
nakkestöte	headrest
nam	name
namar	names
naplur/a	nap (n/v)
narkose	narcosis
narkotika/medisin	drug
narkotisk	narcotic
nasjon	nation
nasjonal	national
nasjonalisera	nationalize
nasjonalitet	nationality
nasjonar	nations
nativ	native
natt, kvel	night
nattergal	nightingale
nattklub	nightclub
nattkule	nightgown
nattlig	nightly
natur	nature
naturlig	NATURAL
naturlig	naturally
naturvetenskap, fisikk	physics
nausej	nausea
navigasjon	navigation
navigera	navigate
navle	navel
neb	beak
ned	downstairs
ned	down
ned going	descent
nedlada	download
nedover	downwards
negativ	negative
neglekta	neglect
neglisjej	negligee
negrar	Negroes
negro	Negro
nej/ingen	no
nejl	nail (finger)
nejlbörste	nailbrush
nejlfil	nail-file
nejllakk	nailpolish
nejlsaks	nail scissors
nemlig	namely
neon	neon
nepe	hardly
ner/da	when (int/rel)
ner/luka	close (a/v)
nera	close (adj)
nerabilde	close-up
nere	near
nerelig, nesten	nearly
nerhelst	whenever
nerhet, visinitet	vicinity
nerlig, fast	closely
nerligande	nearby
nerligande	neighboring
nerre	closer
nerseand	short sighted
nerve	nerve
nervös	nervous
nese	nose
neseblöd	nosebleed
nesebor	nostril
nesehorn	rhinoceros
nesesari, nödig	necessary
nesesitet	necessity
nestan	almost
neste	next
nett	net
nett, ordentlig	neat
nettverk	network
neuter	neuter
neutral	neutral
nevö	nephew
nevralgi	neuralgia
nevrose	neurosis
niese	niece
Nigeria	Nigeria
nigeriansk/nigerian	Nigerian
nik/a	nod (n/v)
nikkel	nickel
nikotin	nicotine
nilon	nylon
nio	nine
niote	ninth
nioti	ninety
niotite	ninetieth
nioton	nineteen
niotonte	nineteenth
nip/a, slurp/a	sip (n/v)
nirvana	nirvana
nitrogene	nitrogen
niu	new
Niu Zeland	New Zealand
niubeginner	learner
niuhetar	news
niuhetar	tidings
niuk	whim
niuke	fad
niuna	hum
niure	kidney
nius/a	sneeze (n/v)
nivoar	levels
njuta	enjoy
njutad	enjoyed
njutesom	enjoyable
njuting	enjoyment
noa	reach
noad	reached
nobilitet	nobility
noble	noble
nöd	distress
nodig	gracious
nödig	urgent
nödighet	urgency
noen gang/alltid	ever
nog	enough
nogen	somebody
nogen tidar, nontid	sometimes
nogen, non	someone
noget	somewhat
nogon	some
nogot, not	something
nogso	fairly
nol/era	needle (n/v)
nolle	zero
nominasjon	nomination
nominell	nominal
nominera	nominate
nonne	nun
nonnekloster	nunnery
nonsens	nonsense
nonsted, nonstans	Somewhere
nord/lig	North (n/adj)
nordlig	northerly
nordlig	northern
nordöst	northeast
nordvest	northwest
Norge	Norway
normal	normal
normalt	normally
norsk/norrman	Norwegian
nosjon	notion
nöt	nut
nöt-kneker	nutcracker
nöt-sjell	nutshell
notad	noted
nötad/kledad sej	wore
notar	notes
notarr	notary
notarr publikk	notary public
note/nota	note (n/v)
notebok	notebook
notoriös	notorious
november	November
nu	now
nu uvanlig, oldendags	quaint
nuanse	nuance
nuklear	nuclear
nuklear	nuclear
nukleus	nucleus
nulig	recent
nulig	recently
null	nought
numer	number
numerar	numbers
numerord	numeral
numerös	numerous
nurissa	nourish
nurissande	nourishing
nurissning	nourishment
nusanse	nuisance
nutid/ström	current
nutildags	nowadays
nutrisjon	nutrition
O	Oh
o so videre	et cetera
o, u (euphon.)	and
oase	oasis
obediens	obedience
obedient	obedient
obeja	obey
objeksjon	objection
objekt/a, protestera	object (n/v)
objektar	objects
objektiv	objective
obligasjon	bond
obligatorisk	compulsory
obligatorisk	obligatory
obligera	obligate
oblitera	obliterate
obor	perch (fish)
obor	bass (fish)
obsenitet	obscenity
obsenn	obscene
observasjon	observation
observatorium	observatory
observera	observe
observerad	observed
obsesjon	obsession
obskurr	obscure
obtenbar	obtainable
obtenera, foa	obtain
obviös	obvious
obviös	self-evident
obviöslig	obviously
odinsdag	Wednesday
ödmjuk/a	humble (a/v)
odor	odor
ödsel	lavish (a)
ofenda	offend
ofensiv	offensive
ofensiv status, atakk	offence (stress1)
ofer/ofra	sacrifice (n/v)
ofera	offer
oferad	offered
ofiser	officer
ofiserar	officers
ofisjel	official
ofisjelar	officials
ofta	often
ofte	frequently
öjabluant	eye-pencil
öjabru	eyebrow
öjalok	eyelid
öjar	eyes
öjasjiuge	eye-shadow
öjavippa	eyelash
öjavitne	eyewitness
öje	eye
ok	yoke
öka	increases
öka/ökning	increase (v/n)
ökad	increased
ökande	increasing
okasjon	occasion
okasjonalt	occasionally
ökologi	ecology
ökologisk	ecological
ökonom	economist
ökonomi	economy
ökonomisk	economical
ökonomisk	Economic
öks	axe
okse	ox
oksisjen	oxygen
oktober	October
oktopus	octopus
okuliste	oculist
okupant	occupant
okupasjon	occupation
okupera	occupy
okuperad/upptakad	occupied (v/a)
ol	eel
öl	beer
öl	ale
old, gamal	old
oldare	older
oldendags	old-fashioned
oldrig, gamal	aged
oldtid	antiquity
oliven	olive
olivenolje	olive oil
oljad, glat	oily
olje	oil
om	whether
om	If
om bord	aboard
öm, mör	tender
om/rundt	about
omelett	omelette
omgia	envelope (v)
omgivningar	surroundings (n)
omgoande	prompt
omhiugelig	thorough
ominös	ominous
omisjon	omission
omita	omit
omkring	around
omnipotentt	omnipotent
omringa, insirkla	encircle
omringa, omgoa	surround (v)
omringande	surrounding (a)
omriss/a	outline (n/v)
omsorg/a	care
omtal/a	mention (n/v)
omtalad	mentioned
onanera	masturbate
onanering	masturbation
ond	wicked
ond/onde	evil (adj/n)
ondska	spite
ondskapsful	spiteful
onga	steam
onge	vapor
onger	steamer
oniks	onyx
onkel, farbror, morbror	uncle
önska, desira	desire
önska/önske, lust	desire
önske/önska	wish (n/v)
opal	opal
opera	opera
operasjon	operation
operasjonar	operations
opererande	operating
operette	operetta
opförsel, komportment	behavior
opinion	opinion
opmuntra	encourage
opna/open	open (v/adj)
opnad	opened
opnande	opening
opning	gap
opning	breach
opning	slot
oponent, motstander	opponent
oponera	contest (v)
oposit	opposite
opresjon	oppression
opressa	oppress
opriktig	frank
opriktig	sincere
opsjon	option
opsjonal	optional
optiker	optician
optimisme	optimism
optimist	optimist
optimistisk	optimistic
or	year
orall	oral
orar	years
ord	word
ordar	words
ordbok	Dictionary
order/ordra	order (n/v)
orderar	orders
ordinari	Ordinary
ordning, setling	settlement
ordrad	ordered
ore	oar
öre	ear
öredob	earring
öretrom	ear-drum
öreverk	earache
orfan	orphan
organ, orgel	organ
organisasjon	Organization
organisasjonar	organizations
organisera	organize
organiserad	organized
organisk	organic
orhundra	century
Orient	Orient
orientalsk	oriental
orientera sej	orientate
origin	origin
originall	original
originalt	originally
orka	stand to
orkann	hurricane
orkestre	orchestra
orlig	yearly
orlig/orbok	annual
örn	eagle
ornament	ornament
ornamentall, dekorativ	ornamental
oroa sej/oro, bekiumer	worry (v/n)
orsak/fororsaka	cause (n/v)
orsakar	causes
ortodoks	orthodox
os, selv	ourselves
osk-	thundery
oske/oska	thunder (n/v)
oskveder	thunderstorm
ösrejn	downpour
öss	us
osso	also
ost	cheese
öst	East
österrike	Austria
österrikisk/österriker	Austrian (a/n)
östers	oyster
östlig	eastern
östlig	easterly
osv	etc
otrisj	ostrich
otta	eight
otte	eighth
otti	eighty
otton	eighteen
ottonte	eighteenth
öu	Island
oval	oval
ovenfor	above
ovenfor	overhead
over	over
over	across
over	over
over natt	overnight
overal	overalls
overalt	throughout
overalt	everywhere
overanstrenga sej	overwork (v)
overanstrengning	overwork (n)
overdriva	exaggerate
overdrivad	excessive
overdrivning	excess
overfilt	crowded
overflöd	abundance
overflodig	superfluous
overflödig, redundant	redundant
overfor	facing
overgang	crossing
overgoa	exceed
overgoa	outdo
overgroad	overgrown
overhala	overhaul
overlerer, rektor	headmaster
overleva	survive
overlevning	survival
oversea	overlook
oversetta	translate
oversetter	translator
oversettning	translation
oversikte	oversight
oversjöisk	overseas
oversjuad	overcast
overskrift	headline
overskrift/direksjon	heading
overtrötad	over-tired
overvegt	overweight
overvelda	overwhelm
overvina	overcome
overvina	defeat
ovn	furnace
ovn	oven
ovn, kök-aparatt	stove
pade	toad
pade-stol	toadstool
padle-ore	paddle
paganism	Paganism
pagann	Pagan
pagina	page
pak/a	pack (n/v)
paka	pack (v)
paka, slo in	wrap (v)
pake	package
Pakistan	Pakistan
pakistansk/pakistanier	Pakistani
pakke	parcel
palass	palace
palme/handflate	palm
palpable	palpable
panel	panel
panelverk	panelling
panikk	panic
panloner	pawnbroker
panne	pan
pansetta	pawn (v)
papa	daddy
papegöye	parrot
paperartiklar	stationery
paperhandel	stationer's
paperskorg	wastebasket
papirr	paper
par	couple
par	pair
parade	parade
parafinn	paraffin
paragraf	paragraph
parakejt	parakeet
paralell	parallel
parapliu	umbrella
parat/ferdig	ready
pardonn/a	pardon (n/v)
parfume	perfume
Paris	Paris
parisj	parish
park/parkera	Park (n/v)
parkering	parking
parlament	parliament
parlamentarisk	parliamentary
parsjal/partisk	partial (parts/bias)
parti	parties
parti/fest	Party
parting	parting
partisjon	partition
partlig	partly
partner	partner
partrisj	partridge
pas-ord	password
pasa til	match (v)
pasande	suitable
pasasje	passage
pasasjerbot	liner
pasasjerr	passenger
pasera	pass
pasera	overtake
paserad	passed
paserande	passing
pasiens	patience
pasient	patient
pasifisme	pacifism
pasifist	pacifist
pasjonn	passion
pasjonnad	passionate
pass	passport
passiv	passive
pasturre	pasture
patent	patent
patriot	patriot
patron	cartridge
patrulje/patruljera	patrol (n/v)
pause/pausa	pause (n/v)
pava	pave
pave	pope
paviljonn	pavilion
paviment	pavement
pedal	pedal
pedikiur	pedicure
pejanöt	peanut
pejsann	peasant
peka ut	designate
peka, indikera	point (v)
pekatt	sin
pekuljar	peculiar
pekuljaritet	peculiarity
pelikan	pelican
pels	fur
pelvis	pelvis
pen	good-looking
pen	handsome
penalti	penalty
pendant	pendant
penetrera	penetrate
pengar	money
pengar-eske	till (n)
pengarpung	purse
penge-	monetary
peninsule	peninsula
penisillin	penicillin
penn	pen
pensjon	pension
pensjon	boarding-house
pensjonad	retired
pensjonat, gasthus	guest-house
pensjonera	retire
pensjonerr	boarder
pensjonskola	boarding-school
pepper	pepper
pepperminte	peppermint
per	per
pere	pear
perfeksjon	perfection
perfekt	perfect
performa	perform
performans	performance
perill	peril
perilös	perilous
periode/punkt	period
perisja	perish
perisjable	perishable
perkolator	percolator
perle	bead
perle	pearl
perlemor	mother-of-pearl
permanent	permanent
permisjon	permission
permit/a	permit (n/v)
permitad	permitted
peroksid	peroxide
perpendikular	perpendicular
persekuta	persecute
persepsjon	perception
perseptible, merkbar	perceptible
persille	parsley
persiva	perceive
persjuri	perjury
person	person
personale	personnel
personar	persons
personel	staff
personlig	personal
personlighet	personality
perspektiv	perspective
perspira	perspire
perspirasjon, svete	perspiration
persuadera, overtala	persuade
persuasjon, overtaling	persuasion
perukk	wig
pesa	pant (v)
pesimisme	pessimism
pesimist	pessimist
pesimistisk	pessimistic
pest	plague
petisjon	petition
petisjon	plea (urg. req.)
petroleum	petroleum
pianist	pianist
piano	piano
pijamas	pyjamas
pikar	girls
pike	girl
pike-nam	maiden name
piknik	picnic
pikolo	bellboy
pikturesk	picturesque
pil	arrow
pilarr	pillar
pilegrim	pilgrim
pilegrimasje	pilgrimage
pille	pill
pilott	pilot
pimpel	pimple
pingst	Whitsun
pingvin	penguin
pinne	peg
pinsett	tweezers
pinsvin	porcupine
pinsvin	hedgehog
pionerr	pioneer
piös	pious
pipe, rör	pipe
pir	fellow
piratera	pirate (v)
piratt, sjöröver	pirate (n)
pistol	pistol
piston	piston
piston-stang	piston rod
pitij	pity
piunelitel	tiny
piutt	puddle
plaga	bother
plakatt	poster
plakatt	placard
plan/nivo/nivelera	level
plan/planera	plan
planar	plans
planerad	planned
planering	planning
planet	planet
planetarium	planetarium
planke	plank
plantar	plants
plantasje	plantation
plante, fabrikk/planta	plant (n/v)
plaserad, setad	placed
plass	square (of city)
plaster	plaster
plastikk	plastic
plate	dish
plate	sheet (glass, etc)
plate/plata	plate (n/v)
platform	platform
platinum	platinum
platö	plateau
plats, rom	space
plats, sted/seta	place
platsviser	usher
platsviserinne	usherette
plejeforeldrar	foster-parents
plesant	pleasant
plesjur, behag	pleasure
plikt/tolavgift	duty
plog/plöua	plough (n/v)
plome	plum
plonbok	wallet
plötslig	sudden
plötsligt	Suddenly
plug/-a	plug (n/v)
pluka	pick
pluka, velga/valg	pick (v/n)
plukad	picked
plurall	plural
plus	plus
pneumonie	pneumonia
po	onto
po	on
po	upon
po (ut)selning	on sale
po langs	lengthways
po nogen moda	somehow
poem	poem
poemar	poems
poengsum/fo poeng/markera score (n/v/v)
poesi	poetry
poeter	poet
poetisk	poetic
pofogel	peacock
pojkar	boys
pojke	boy
pokketbok	paperback
pokledningsrum	dressing-room
pöl	pool
polak	Pole
Poland	Poland
polera	polish (v)
polio	polio
poliss	Police
poliss-stasjon	police station
polissman	policeman
politik	policy
politikar	policies
politikk	politics
politikk, polise	policy
politisk	political
politt	polite
polittiker	politician
polsk	Polish
polusjon	pollution
poni	pony
poplin	poplin
popmusikk	pop music
populasjon	population
populerr	popular
populös	populous
porselen	porcelain
porsjon	helping (n)
port	gate
portier	doorman
portner	porter
porto	postage
portofri	postage paid
portrett	portrait
Portugal	Portugal
portugesisk/portugess	Portuguese
posesjon	possession
posessa, eja	possess
posisjon	position
positiv	positive
poske	easter
poskelilje	daffodil
post-	post- (after)
post-eske	mailbox
post/a	post
post/a	mail (n/v)
postand	plea (legal)
poste restante	poste restante
postkasse	letter-box
postkort	postcard
postman	postman
postnumer	zip code
pote, tass	paw
potejtt	potato
potensjel	potential
pott	pot
povre/dorlig	poor
povretet	poverty
praksis	Practice (n)
praktful	gorgeous
praktisera	practise (v)
praktisk	practical
praktiskt	practically
prat/a	chat
pratsam	talkative
precausjon	precaution
predesesör, forganger	predecessor
predikta	predict
prefera	prefer
preferable	preferable
preferans	preference
prefiks	prefix
preka	preach
preken	sermon
preker	preacher
prekerr	precarious
prekestol, talerstol	pulpit
preliminerr	preliminary
prematurr	premature
premie/vurdera	prize (n/v)
premisar, ejendom	premises
premium, forsikringspris	premium
prenumerant	subscriber
prenumerasjon	subscription
prepara	prepare
preparad	prepared
preparasjon	preparation
preposisjon	preposition
pres	pressure
pres-koker	pressure cooker
presang, gave	present (n)
preseda	precede
presenning	tarpaulin
presens	presence
present/presentera	present (a/v)
presenta, akta, performa	stage (v)
presenterad	presented
preserande	pressing
preserva	preserve
preservasjon	preservation
president	president
presiös, kostbar	precious
presipitasjon	precipitation
presiss	precise
presjudiss, fordom	prejudice
preskripsjon	prescription
preskriva	prescribe
press/presera, triuka	press (n/v)
prest	priest
prest	clergyman
prest	parson
prestasjon	achievement
prestasjon	feat
prestegord	parsonage
presterad	achieved
prestesse	priestess
prestisje	prestige
presumable	presumable
presumptuös, overmodig	presumptuous
pretekst	pretext
pretenda	pretend
pretens	pretence
preventa, forhindra	prevent
preventiv	preventive
previöslig	previously
prika	prick (v)
primerlig	primarily
primerr	primary
prins	prince
prinsesse	princess
prinsipal, höd-	principal
prinsipp	principle
prinsippar	PRINCIPLES
prioritet	priority
priörr, forutgoande	prior
pris	Price
pris/tildela	award
prisar	prices
prisfal, deklin, depresjonslump
prisjon	gaol, jail
prisliste	price list
prislös	priceless
prisonerr, fange	prisoner
prisonn, fengsel	prison
privat, personlig	private
privatliv	privacy
privilegium	privilege
probable	probable
probabligt	probably
problemm	problem
problemmar	problems
produksjon	production
produksjon, utgang	output
produkt	product
produktar	products
produsad	produced
produsentt	producer
produsera/naturproduktar	produce (v/n)
profesjon	profession
profesjonell	professional
professor	professor
profett	prophet
profit/era (av)	profit (n/v)
profitable, inbringande	profitable
profunde	profound
programerer	programmer
programm/programera	program (n/v)
programmar	programs
progres/a	progress
progressiv	progressive
prohibisjon	prohibition
prohibita	prohibit
prohibitiv	prohibitive
proklama	proclaim
promenadd/promenera	stroll (n/v)
promenade	promenade (n)
promenera	walk
promenerad	walked
promis/-era	promise (n/v)
promosjon	promotion
promotera	promote
pronomen	pronoun
propagande	propaganda
propela	propel
propell	propeller
propertiar	properties
proporsjon	proportion
proporsjonell	proportional
proposa	propose
proposad	PROPOSED
proposal	proposal
proposisjon	proposition
prosedur	procedure
prosedurar	procedures
prosekuta	prosecute
prosent	percent
prosentdel	percentage
prosesjon	procession
prosess	process
prosessar	processes
prosjekt/-a	project (n/v)
prosjektar	projects (n)
prosperitet	prosperity
prosperös	prosperous
prosperös	well-to-do
prostituad	prostitute
protein	protein
proteksjon	protection
protekta	protect
protektad	protected
protest/-era	protest (n/v)
protestant	Protestant
protestantisk	Protestant
protestantism	Protestantism
pröva	rehearse
pröva	try on
provar	tests
pröve	rehearsal
proverb	proverb
pröverum	fitting room
proviant	provisions
providens	Providence
providera	provide
providera	provides
providerad	provided
providerande/forutsat at	providing
provins	province
provinsiell	provincial
provisionall	provisional
prudent	prudent
pruinn	prune
psikiater	psychiatrist
psikisk	psychic
psikoanalitiker	psychoanalyst
psikolog	psychologist
psikologi	psychology
psikologisk	psychological
publik	audience
publikasjon	publication
publikk	public
publisitet	publicity
pude, notesblok	pad
puder	powder
puder-kvast	powder-puff
pullover	pullover
puls	pulse
pumpe/pumpa	pump (n/v)
pund	pound
punera	punish
punering	punishment
pung	pouch
punkt	dot/point
punkt-lius	spotlight
punkt/spiss	point (n)
punktar	items
punktar	points
punktera/punktering	puncture (v/n)
punktlig	punctual
pupill	pupil (eye)
pur, absolutt/sjerr	sheer (adj/adj)
purpurfarge	purple
puslespill	puzzle (n)
pust	breath
pusta	breathe
pute, hödpute	pillow
putevar	pillow-case
rabarbre	rhubarb
rabatt	rebate
rabatt, avslag	discount
rabies	rabies
rad/roa	row [rou] n/v
radering	etching
radiasjon	radiation
radiator	radiator
radikal	radical
radio	radio
radio	wireless
radius	radius
rafina	refine
rafineri	refinery
rajt/höure (side)	right n,a/a
rajtar	rights
rajtjös	righteous
rak/t	straight (a/adv)
rake/a	rake (n/v)
rakett	rocket
rakket	racquet
rally/samla sej	rally (n/v)
rama	frame
rame	frame
rampe	ramp
ran	robbery
rana	rob
rand	brim
rand	stripe
randig	striped
rang/-a	rank
ransel	satchel
ransid	rancid
ransman	robber
raportar	reports
raportera/raport	report
raporterad	reported
rar, simpatisk	nice
